----------------------------------------------------------------------------------------------------
----------------------------------------------------------------------------------------------------
----------------------------------------------------------------------------------------XXXX--------
-----------------------------------------------------------------------------------------[]---------
------xxx--xxxxx-------------------------------------------------------------------------[]-------xx
-----xx--xxx----x------------------------------------------------------------------------<>------xx<
----xx----x------x------------------------------------------------------------------------------xxX[
----x----<>-------x-----------------------------------------------------------------------E-----xXX[
--xxx----[]--------xxxxx--------------------------------------xxx-----------------------------xxxXX[
-xx<>--QQQQ?--------xXX-x-----------------E------E-----------xx--xxx--------xxxx--------xxxx-xx<>XX[
xx-[]---------------XXX--x---------------<>-----<>--------x-xx---<>-x------xx---xx-----xx---xxX[]XX[
<>-[]--------------XXXX---x--------------[]-----[]---------xx----[]--x----xx---<>-x---xx---<>XX[]XX[
[]-[]-------E-----XXXXX----xxxxxxxxxxxxxx[]-----[]---------<>----[]---x--xx----[]--xxxx----[]XX[]XX[
XXXXX-------X-----XXXXXXXXXXXXXXXXXXXXXXX[]-----[]---------[]----[]----xxx-----XXXXXXXX----[]XXXXXXX