----------------------------------------------------------------------------------------------------
----------------------------------------------------------------------------------------------------
---------------------------------SSSSSSSSSSSSSSSSSSSSSSSSSSSSSSSSSSSSSSSSSSSSSSSSSS?SS--------------
-----------------------------------[]----[]------------------------------------------S--------------
-----------------------------------[]----[]------E---------------xxx-----------------XXX------------
-----------------------------------[]----[]---QQQQQ--------xxxxxxx--x-------------------------------
o----------------------------------<>----[]---------------xxSSSSSS---xxxxx--------------------------
-----------------------------------------[]--------------xx-SSSSSS--SSSSS-x-----------------S-------
---------xxxx----S-----------------------[]--xxxxxxxxxxxxx--SSSSSS--SSSSS--xxxxx--------------------
--------xx<>-x---------xxxx--------------[]-xxSSSSSSSSSSSS--SSSSSS--SSSSS?SS?SS-xxxxxxx-------xxxx--
x------xx-[]--x-------xx---x-------------<>xx-SSSSSSSSSSSS-------S----------SSSSSSSSXX-x-----xx---xx
-x----xx--[]---x-----xx-----x-----xxx-----xx--SSSSSSSSSSSS-------S<>--------SSSSSSSS----x---xx----XX
--xxxxx---[]----xxxxxx-----X-xxxxxx--xxxxxx---SSSSSSSSSSSS--------[]---------------------xxxx-------
XXXXXXXXXXXXXXXXXXXXXX---XXXXXXXXXX--XXXXXXE--XXXXXXXXXXXXXXXXXXXXXXXXXXXXXXXX-X-XX------XXXX-------