----------------------------------------------------------------------------------------------------
----------------------------------------------------------------------------------------------------
SSSSSSSSSSSSSSSSSSSSSSSSSSSSSSSSSSSSSSSSSSSSSSSSSSSSSSSSSSSSSSSSSSSSSSSSSSSSSSSSSSSSSSSSSSSSSSSSSSSS
------------------------------------------------------SSSSSSSSSSSSSSSSSSSSSSSSSSSSSSSSSSSSS---------
------------------------------------------------------SSSSSSSSSSSSSSSSSSSSSSSSSSSSSSSSSSSSS---------
---------------------ooooo----------------------------SSSSSSSSSSSSSSSSSSSSSSSSSSSSSSSSSSSSS--QQ-----
---------o------------------------------------------------------------------------------------------
--Q--xxxxx---------S-SSSSS-S-------------xxxx----------------xxx-----------------xxx------xxx-xxx--x
xxxxxx--S-x--------SoS--SSoS-----------xxx---x--------xxxxxxxx?-xxxxxxxxxxxxxxxxxx?-xxxxxxx--xx--xxx
xXXXXX-----xxx-----SSS--SSSS----------xx<>----x------xx-SSSSSS??SSSSSSSSSSSSSSSSSS--SSSSSSS--QQ--QQ?
-XXXXXXX--XXX-xx---------------------xx-[]-----xxx--xx--SSSSS---SSSSSSSSSSSSSSSSSS------------------
-XXXXXXX--XXXXX-x-------------------xx--[]-----<>-xxx---SSSSS---SSSSSSSSSSSSSSSSSS------------------
xXXXXXXXE-XXXXX--xxxxxxxxxxxxxxxxxxxx---[]---E-[]--x---------oooSSSSSSSSSSSSSSSSSS------------------
XXXXXXXXXXXXXXXXXXXXXXXXXXXXXXXXXXXXXXXXXXXXXXXXXXXX---XXXXXXXXXXXXXXXXXXXXXXXXXXXXXXXXXXXXXXXXXXXXX