----------------------------------------------------------------------------------------------------
----------------------------------------------------------------------------------------------------
----------------------------------------------------------------------------------------------------
----------------------------------------------------------------------------------------------------
----------------------------------------------------------------------------------------------------
-E--------------------------------------------------------------------xxx---------------------------
<>-------------------------------------------------------------------xxX-x--------------------------
[]--------------------------------------------------------oo--------xxXX--x-------------xxxxx-------
[]----------------------<>------------------oo-------xxxxx---------xxXXX---x----------xxx-<>-x------
bQQQQ-------------------[]-----------------o--o-----xxXXX-x-------xx-XXX----x--------xxQ?-[]--x-----
B--------------------------------------------------xxXXXX--x-----xxXXXXX-----x------xx----[]---x----
b----------xxxxx-----------------xxx--------------xxXXXXX---x---xxXXXXXX------x----xx-----[]----x---
xxxxxxxxxxxx----xxxxxxxxxxxxxxxxxx--xxxxxxxxxxxxxxxXXXXXX----xxxx----XXX-------xxxxx--X---[]-----xxx
XXXXXXXXXXXX----XXXXXXXXXXXXXXXXXX--XXXXXXXXXXXXXXXXXXXX---XXXXXXXXXXXXXXXXXXXXXXXXXXXXXXXXXXX-XXXXX