----------------------------------------------------------------------------------------------------
----------------------------------------------------------------------------------------------------
----------------------------------------------------------------------------------------------------
----------------------------------------------------------------------------------------------------
--oo---------------xxxxx-o-o---------ooo------------------------------------------------------------
--X---------------xx-XX-xo-o---------XXX---------------------XXX----------------------------------XX
-----------------xx------x----------------------------SSSSSSSSSSSSSSSS---------xxx------------------
-----------xxxxxxx--------x----------------------------------------------------xB-x------S----------
--------xxxx----x----------xx---------------xxx--------------------xxxx-------xxb-------------------
-------xxXXX---XX---------XX-x-------------xx--x-----------SSSSSS-xx--xxx----xxXXX-xS-------?-------
Q?----xx-------XXX------------x-----------xx----x----------------xx------x--xxXXXX--x-----xxx-------
-----xx------------------------x---------xx---------------------xx--------xxxXXXXX---x---xxB-x------
xxxxxx--------------------------xxxxxxxxxx------Xxxxxxxxxxxxxxxxx----------xXXXXXX----xxxx-b--xxxxxx
XXXXXXXXX----------------------XXXXXXXXXXX------XXXXXXXXXXXXXXXXX------S---XXXXXXXXXXXXXXXXXXXXXXXXX