---------------------xxx--------------------------
--------------------xx--x-------------------------
-------------------xx----x------------------------
-------------xxxxxxx------x-------------xxx-------
------------xx----x--------x---------xxxx--x------
-SSS--------xX----E---------x-------xx--X---x-----
-]---------xx----<>----------x-----xx--------x----
-]---------x-----[]-----------xxxxxxE---------x---
-]-------xxx-----[]------------x---<>----------x--
<>------xx<>-----[]------------?---[]-----------x-
-------xx-[]-----[]----------------[]------------x
-E----xx--[]-----[]----------------[]-------------
xxxxxxx---[]-----[]------E-----X---[]------------X
XXXXXXXEXXXX-----XXXXXXX<>XXXXXX---XXXXXXX-------X