----------------------------------------------------------------------------------------------------
----------------------------------------------------------------------------------------------------
XX-X------------------------------------------------------------------------------------------------
]---------------------------------------------------------------------------------------------------
]---------------------------------------------------------------------------------------------------
]---------------------------------------------------------------------------------------------------
>---------------------------------------------------------------------------------------------------
---------------------------------------------------------------------------------------------------x
xxxxxx----------------------S----------------xxxx----------------------------xx-------------------xx
SSSSS-x----------------------------xxx------xx<>-x--------------------xxxx--xx-x-----------------xxX
S------x----------xxxx-----xxx----xxX-x----xx-[]--x----QQQQQQ?-------xx---xxx---x---------------xxXX
Q-------x--------xx<>-x---xxS-x--xx-X--x--xx--[]---x---------------xxx-----x-----xx------------xxXXX
---------xxxxxxxxx-[]--xxxx-S--xxx--X---xxx---[]----xxxxxxxxxxxxxxxxXX-----X-----X-xxxxxxxxxxxxxXXXX
XXXXXX---XXEXXXXXXXXXXXX<>XXXXXXXXXXXXXXXXXXXXXXXXXXXXXXXXXXXXXXXXXXXX-----X-----XXXXXXXXXXXXXXXXXXX