----------------------------------------------------------------------------------------------------
--------------xx------------------------------------------------------------------------------------
-------------xx-x-------------------------------------------------------S---------------------------
------------xx---x----------------------------------------------------------------------------------
-------xxxxxx-----x-----------------------------------------------------------E---------------------
-------xSSSSS------xSSSSS-------------------------------------SSSSSSSSSSS---QQQQQQQ----------------E
-------x------------x-----------------------------------------------------------------------------SS
--xxxxxx-------------x--xx--------------------------------------------------------------------------
-xx---xE--------------xxxXx-----------oo---------------------------xx----------E--------------X-E--E
xx----<>---------------xXX-x---------xxxx-------------------xxxx--xx-x-------QQQQQQ-----------XS?SSS
x-----[]---------------XXX--x-------xx---x-------B--Q?QQ---xx---xxx---x-------------------xxx-------
>-----[]--------------XXXX---x-----xx-----x------b--------xx-----x-----x-----------------xxX-xSSSSSS
]--E--[]------------ooXXXX----xxxxxx-------xxxxxxxxxxxxxxxxX-----X------xxxxxxxxxxxxxxxxxx-X--xxxxxx
XXXXXXXXXXXX--------XXXXXXXXXXXXXXXX------XXXXXXXXXXXXXXXXXX-----X-----XXXXXXXXXXXXXXXXXXXXXXXXXXXXX