----------------------------------------------xxxx
-----xxxxxxxxxxxxxxxxxxxxxxxxxxxxxxxxxxxxxxxxxx---
---xxxSSSSS??SSSSSSSSSSSSSSSSSSSSSSSSSSSSSSSSSS---
xxxxSS--------------------------------------------
xSSS----------------------------------------------
xSSS----------------------------------------------
x-------------------------------------------------
xS------------------------------------------------
S-SS--XX--------------------------------XXX-------
-----XXX------------------------XXX---------------
----XXXX-XXXX-----------XXX-----------------------
---XXXXX-XXXX--XXX--------------------------------
--XXXXXXXXXXX-------------------------------------
XXXXXXXXXXXXX----------------------------------XXX