-------------------------------------------------------------------------------------xxx------------
------------------------------------------------------------------------------------xx--x-----------
-----------------------------------------------------------------------oo----------xx----x-----xxxx-
----------------------------------------------------------------------------------xx------x---xx---x
-------------------------------------xxxxx--------------------------------------xxx--------x-xx-----
-E--------------------------------E-xxXXX-x----------------------------XXX-----xx<>---------xx------
<>---------------------------------xxXXXX--x----------------------------------xx-[]---------XX------
[]------xxxxx----xxxx-------------xxXXXXX---x--------------------------------xx--[]-----------------
[]----xxx----x-xxx---x----------xxxXXXXXX----x---------------------------xxxxx---[]-----------------
XXX--xx<>-----xx<>----xx-------xx<>XXXXXX-----x-----------------XXXX----xxXXXX---[]-----------------
----xx-[]----E<>[]---<>-x-----xx-[]XXXXXX------x-----------------------xx--------[]-----------------
---xx--[]---<>[][]---[]--x---xx-X[]XXXXXX-------xxx-------xxx---xxx---xx---------[]-----------------
xxxx---[]---[][][]---[]---xxxx-XX[]XXXXXX-------XX-xxxxxxxx--xxxx--xxxx----------[]----------------o
XXXXXXXXXXXXXXXXXXXXXXXXXXXXXXXXXXXXXXXXXXXXXXXXXXXXXXXXXXX--XXXX--XXXX--------XXXXXXXXXX----------X