----------------------------------------------------------------------------------------------------
----------------------------------------------------------------------------------------------------
----------------------------------------------------------------------------------------E-----------
----------------------------------------------------------------------------------------------------
-------xxxxxxxxxxxx------------------------xxxxxx---------------------------------------------------
------xx--QQQ?QQQQ-x----------------------xx?SSS-x---------------------------------SSSSS?S--------S-
-----xx-------------x---------------------x-------x-------------------------------------------------
----xx------E----E---x---------------xxxxxx-------Ex------------------------------------------------
--xxx-----SSSSSSSS----x-------------xx---xE------<>-x--------------------------------------------xxx
-xx<>------------------x-----------xx----<>---E--[]--x------------------xxx-----S---E----S------xx<>
xx-[]-------X----X------x--------xxx-----[]--<>--[]---x----------------xxX-x-------------------xx-[]
x--[]-------X----X-------x------xx<>-----[]--[]--[]----x-xxxxx-------Exx-X--x-----------------xx--[]
E--[]----E--X----X--------xxxxxxx-[]--E--[]--[]--[]-----xx----xxxxxxxxx--X---xxxxxxxxxxxxxxxxxx---[]
XXXXXXXXXXXXXXXXXXXXXXXXXXXXXXXXXXXXXXXXXXXXXXXXXXXXXXXXXX---XXXXXXXXXX--XXXXXXXXXXXXXXXXXXXXXXXXXXX