----------------------------------------------------------------------------------------------------
----------------------------------------------------------------------------------------------------
----------------------------------------------------------------------------------------------------
----------------------------------------------------------------------------------------------------
----------------------------------------------------------------------------------------------------
---------------------------------------------------------------Q-------------------xxxxx------------
----------------------------------------------------------------------------------xx-<>-x-----------
x--------------------------------------------------------------------------------xx--[]--x----------
-x-------------------------------S----------------xxxx-----X-------------------xxx---[]---x---------
--x--------xxx--------------------------xxx------xx<>-x----X-S?SQS------------xx<>--QQQ?---x--------
X--x------xxX-x-----------------xxx----xxX-x----xx-[]--x------------xxxx-----xx-[]----------x-------
----x----xx-X--x---------------xxS-x--xx-X--x--xx--[]---x----------xx<>-x---xx--[]-----------x-----x
x----xxxxx--X---xxxxxxxxxxxxxxxx-S--xxx--X---xxx---[]----xxxxxxxxxxx-[]--xxxx---[]------E-----xxxxxx
XX---XXXXXXXX--XXXXXXXXXXXXXXX>XXXXXXXXXXXXXXXXXXXXXXXXXXXXXXXXXXXXXXXXXXXXXXXXXXXXX----X---XXXXXXXX