----------------------------------------------------------------------------------------------------
----------------------------------------------------------------------------------------------------
----------------------------------------------------------------------------------------------------
----------------------------------------------------------------------------------------------------
------------------------------------------------E---------------------------------------------------
-------------------xxxxS-------SSS-------------SSSSSSS---SSSQ--------------?-----------SSS---SQQS---
------------------xx--xxx---------------------------------------------------------------------------
-----------------xx------x-xxx----------------------------------------------------------------------
----------------xx----E-EExx--xx--------------------------------------------------------------------
E--------------xxX--------XX-XX-x------------?S-------------S-----SS----Q--Q--Q-----S---------SS----
>--------E----xxXXX-------XX-XX--x-----------------------------------------------------------------x
]-------<>---xxXXXX-------XX-XXX--x----------------xxxxx------------------------------------------xx
x-xxxxxxxxxxxxXXXX--------X--XXX--Exxxxxxxxxxxxxxxxx----xxxxxxxxxxxxxxxxxxxxxxxxxxxxxxxxxxxxxxxxxxxX
XXXXXXXXXXXXXXXXXX--------X--XXXXXXXXXXXXXXXXXXXXXXX---XXXXXXXXXXXXXXXXXXXXXXXXXXXXXXXXXXXXXXXXXXXXX