--------------------------------------------------
--------------------------------------------------
--------------------------------------------------
--------------------------------------------------
------------------------------------------------E-
--------------------------------------------SSSSSS
--------------------------------------------------
-------------------------B------------------------
-------------------------b-------------------E----
-----------------------SSXSS-------xxxxx---SSSSSSS
---------------S?-BE--------------xx-<>-x---------
xxx---------------b----------B---xx--[]--x--------
EE-xxxxxxxxxxxxxxxxxxxxxxxxxxxxxxx---[]---xxxxxxxx
XXXXXXXXXXXXXXXXXXXXXXXXXXXXXXXXXX--XXXXXXXXXXXXXX