----------------------------------------------------------------------------------------------------
----------------------------------------------------------------------------------------------------
-SSSSSSS-----------------------------------------------------------------------------------------oo-
-[--------------------------------------------------------------------------------------------------
-[--------------------------------------------------------------------------------------------------
-[---QQ-xxxxx------------------------------------------------------------------------------------XXX
-<-----xx-<>-xx-------------------------------------------------------------------------------------
--xxx-xx--[]-X-x------------------------------------------------------------------------------------
xxx--xx---[]-X--x-----------------------S------------------xxxx--------------X---------------------x
x<>--QQ--QQQ?X---x-----------------------------xxx--------xx<>-x----------X---------------XXXX----xx
-[]----X-----X----x-----------xxxx-----xxx----xxX-x------xx-[]--x----QQQQQX----------------------xx-
-[]----X-----X-----xxx-------xx<>-x---xxS-x--xx-X--x-SSoxx--[]---x--------X---------xxx---xxx---xx--
-[]----X-----X-----XX-xxxxxxxx-[]--xxxx-S--xxx--X---xxxxx---[]----xxxxxxxxxxxxxxxxxxx--xxxx--xxxx---
XXX--XXX-----X----XXXXXXXXXXXXXXXXXX<>XXXXXXXXXXXXXXXXXXXXXXXXXXXXXXXXXXXXXXXXXXXXXXX--XXXX--XXXX---