----------------------------------------------------------------------------------------------------
---------------------------------------------xxxxxxxxxxxxxxxxxxxxxxxx-------------------------------
SSSSSSSSSSSSSSSSSSSSSSSSSSSSSSSSSSSSS-------xxSSSSSSSSSSSSSSSSSSSSSS-x---SSSSSSSSSSSSSSSSS------SSSS
-------SSSSSSSSSSSSSSSSSSSSS---------------xx-------------------------x--SSSSS----------------------
-------SSSSSSSSSSSSSSSSSSSSS-------x--XXX-xx---------------------------x-SSSSS----------------------
-------SSSSSSSSSSSSSSSSSSSSS--QQ---x-xxxx-xSSS----------E---------------xSSSSS-------------xxx------
------------------------------------xx---xx--S---------<>----------------x----------------xx--x-----
--------------xxx----------xxx-xxx--x-----xS-----------[]-----------------x--------------xx----xo---
-------xxxxxxxx?-xxxxxxxxxxx--xx--xx------S-S----------[]-----------------oxxxx------xxxxx------x---
--E---xx-SSSSSS??SSSSSSSSSSS--QQ--QQ---------S-----E-SS[]----------------S?SSS-x----xx-XXX-------xxx
-->--xx--SSSSS---SSSSSSSSSSS----------------------<>---[]----<>----------SSS----x--xx-------S----<>-
--]-xx---SSSSS---SSSSSSSSSSS----------------------[]---[]----[]---<>-----SS------xxx-------------[]-
E-]xx---------oooSSSSSSSSSSS----------------------[]---[]----[]---[]-------E--EE--xX-------------[]-
XXXXX---XXXXXXXXXXXXXXXXXXXXXXXXXXXXX-----XXXXXXXXXXXXXXXXX--XX---XXXXXXXXX-XXXXXXXX-------------XXX