----------------------------------------------------------------------------------------------------
----------------------------------------------------------------------------------------------------
----------------------------------------------------------------------------------------------------
-----------xxx-------------------------------xxx----------------------------------------------------
-----xxxxxxx--x-------------------xxxx-----xxx--x---------------------------xxxxxxxxxxx----------E-E
----xx--QQQ?---x-----------------xx---x---xxXS---x-------------------------xx--QQQ?QQQ-x-------SSSSS
---xx-----------x---------------xx-----x-xxEX-----x-----------------------xx------------x-----------
--xx------E------x-------------xx-------xxXXX------x---------------------xx------E-------x----------
xxx-----SSSS------x----------xxx--------XXXXXS------x------------------xxx-----SSSSSSS----x---------
x<>----------------x--------xx<>-------XXXXXX--------x---------B------xx<>--------------E--x--------
-[]-------X---------x------xx-[]------XXXXXXX---------x--------b-----xx-[]-------X------X---x---E---
X[]-------X----------x----xx--[]-----XXXXXXXX----------x-------B----xx--[]-------X------X----x-----x
-[]----E--X-----------xxxxx---[]----XXXXXXXXX---------X-xxxxxxxxxxxxx---[]----E--X------X-----xxxxxx
XXXXXXXXXXXXXXXXXXXXXXXXXXXXXXXXXXXXXXXXXXXXXXXXXXXXX-XXXXXXXXXXXXXXXXXXXXXXXXXXXXXXXXXXXXXXXXXXXXXX