----------------------------------------------------------------------------------------------------
----------------------------------------------------------------------------------------------------
----------------------------------------------------------------------------------------------------
----------------------------------------------------------------------------------------------------
--------------SS------------------------------------------------------------------------------------
---------------------Q-----------------------------------------------------------------E-E----------
----------------------------------------xxxx------------------------------------------<><>----------
---------------------------------------xx---x-----------------------------------------[][]----------
--------------------------------------xx-----xxx-------xxxx----S-----------------Q?---QQQQ----------
---QQQQQ?QQQQQQQQ--S?SQS------------xxx------<>-x-----xx<>-x---------------------------------------Q
--------------------------xxxx-----xx<>------[]--x---xx-[]--x---------------------------------xxxx--
xxx----------------------xx<>-x---xx-[]------[]---x-xx--[]---x-----xxx------------xxxx-------xx<>-x-
EE-xxxxxxxxxxxxxxxxxxxxxxx-[]--xxxx--[]-E----[]----xx-E-[]----xxxxxx--xxxxxxxxxxxxx---xxxxxxxx-[]--x
XXXXXXXXEEXXXXXXXXXXXXXXXXXXXXXXXXXXXXXXXXXXXXXXXXXXXXXXXXXXXXXXXXXX--XXXXXXXXXXXXX---XXXXXXXXXXXX-X