--------------------------------------------------
--------------------------------------------------
SSSSSSSSSSSSSSSSSSSSSSSSSSS?SSSSSSSSSSSSSSSSSSSSSS
SSSSSSSS------SSSS--------------------------------
SSSSSSSS--E---SSSS--------------------------------
SSSSSSSS--SS----------oooooo----------------------
-----S----SS--------------------------------xx----
-----S----SS----------SSSSSS---------------xx-x-xx
x----So??-SS---E------SSSSSS--------------xx---xx-
-x---SSS--SS--SSSS----------------------xxx----<>-
--x----------EE------------------------xx<>----[]-
---x-------------xxxxx----------------xx-[]----[]-
oooExxxxxxxxxxxxxx----xxxxxxxxxxxxxxxxx--[]----[]-
XXXXXXXXXXXXXXXXXX---XXXXXXXXXXXXXXXXXXXXXXXXXXXXX