-------------------------------------X--------------------------------------------------------------
----------------------------------------------------------------------------------------------------
----------------------------------------------------------------------------------------------------
----------------------------------------------------------------------------------------------------
----------------------------------------------------------------xxx--------xxx-------xxx------------
E--------------------------------------------------------------xx--x------xx--xxxxxxxx--x-----------
>-------------------------------------------------------------xx-E--x----xx---XXXSSSSS---x----------
]------------------------------------------------------------xx------x--xx----------------x---------
]---------------------xxx-----------------------------xxxxxxxx------X-xxx-----o-o-o--------xxx------
]-xxx----------------xx--xxxxxxxxxxxxxxxx------------xx--XXXXX-------oXXX-----o-o-o-XX-----<>-x-----
xxxX-x--------------xx---XXXXXXXXXXXXX<>-x----------xx---------------o---------------------[]--x---x
-x-X--x-----------xxx----XX-----------[]--x------B-xx-S------------------------------------[]---x-xx
---X---xxxxxxxxxxxXXX----XX-----------[]---xxxxxxxxx--S------------------------------------[]----xx-
XXXXXXXXXXXXXXXXXX--X----XX-----------[]---XXXXXXXXX--XXX---------------------------------XXXXXXXXXX