--------------------------------------------------
--------------------------------------------------
------------SSSSSSSSSSS--SS-----------------------
--------------[]-----[S---------------------------
--------------[]-----[S---------------------------
--------------[]-----<S---------------------------
--------------<>-----[S-------------------xxxx----
---------------------[S------------------xxXX-x---
--xx-----------------[S-----------------xxXXX--x--
-xx-x----------------]S-xxxxx----------xxXXXX---x-
xx---x--------------E>-xxSSS-x--------xxXXXXX----x
x-----xx-----xxx------xx-SSS--x------xxXXXXXX-----
B----XX-xxxxxx--xxxxxxx--SSS---xxxxxxxXXXXXXX-----
X----XXXXXXXXX--XXXXXXX--XXX-XXXXXXXXXXXXXXX--XXXX