----------------------------------------------------------------------------------------------------
----------------------------------------------------------------------------------------------------
SSSS--------------------------------E---------------------------------------------------------------
SSSS-------------------XXX--------------------------------------------------------------------------
SSSS------------------XX--------------------------xxxxxxxxxxx----------E-E----------------xxxxx-----
SSSS-----------------XXX--x----------------------xx--QQQ?QQQ-x-------SSSSSSS-SS-xxxx-----xxXXX-x----
SSSS----------------XXXX---x--------------------xx------------x-------------E--xx---x---xx-XXX--x---
SSSS---------------XXXXX----x------------------xx------E-------x--------------xx-----x-xx--XXX---x--
SSSS--------------XXXXXX-----x---------------xxx-----SSSSSSS----x-----------xxx-------xx---XXX----x-
SSSS--------E----XXXXXXX------x-------------xx<>--------------E--x---------xx<>-------<>--XXXX-----x
SSSS---E---<>---XXXXXXXX-------x-----------xx-[]-------X------X---x---E---xx-[]-------[]-XXXXX------
SSSS--<>---[]--XXXXXXXXX--------x---------xx--[]-------X------X----x-----xx--[]-------[]-XXXXX------
SSSS--[]---[]-XXXXXXXXXX-------X-xxxxxxxxxx---[]----E--X------X-----xxxxxx---[]-------[]-XXXXX------
XXXX--XX---XXXXXXXXXXXXXXXXXXXXXXXXXXXXXXXXXXXXXXXXXXXXXXXXXXXXXXXXXXXXXXXXXXXX-------XX-XXXXXXXXXXX