----------------------------------------------------------------------------------------------------
----------------------------------------------------------------------------------------------------
-SSSSSSSSSSSSSSSSSSSSSSSSSSSSSSSSSSSSSSSSSSSSSSSS------------ESSSSSSSSSSSSSSSSSSSSSSSSSSSSSSSSSSSSSS
-[]-------------------------------------------------------------------------------------------------
-[]------------------------------------------------XXX----------------------------------------------
-<--------------------------------------------------------------------------------------------------
--E--------------xx----------------------------------------------------------------------o----------
----------------xx-x-xxx-----------------------------------------------------xx------xxxxx----------
--xx-----------xx---xx--x---------------------xxxxx-----SSSSS?--------------xxX---xxxx--S-x---------
-xx-x--------xxx----<>---x------xxxx---------xxXXX-xxxx--------------xxxx--xxXX--xxXXX-----xxxxxxx--
xx---x------xx<>----[]----xxx--xxSS-x-------xxEXXX-XXX-x------------xx---xxxXXXxxxXXXXXX--XX-x----x-
x-----x----xx-[]----[]----<>-xxx-SS--x-----xxXXXXX------x----------xx-----xXXXXXXXXXXXXX--XXXX-----x
-------xxxxx--[]----[]--E-[]--x--SS---xxxxxxXXXXXX-------xxxxx----xx-----XXXXXXXXXXXXXXXE-XXXX-----X
X-----XXXXXXXXXXXXXXXXXXXXXXXXX--XX--XXXXXXXXXXXX-------XXXXXXxxxxx------XXXXXXXXXXXXXXXXXXXXX-----X