----------------------------------------------------------------------------------------------------
----------------------------------------------------------------------------------------------------
----------------------------------------------------------------------------------------------------
----------------------------------------------------------------------------------------------------
------------oo--------------------------------------------------------------------------------------
--------------------------------------------xx------------------------------------------------------
-xxxxx-------------------------------------xxXx-----------------------------------------------------
xx----x-----------------------------------xxXX-x--------------xxxxx---------------------------------
x------xxx-------------------------------xxXXX--x----------xxxx-<>-x--------------------------------
-E-----<>-x-----------------------------xxXXXX---x--------xxQQ?-[]--x-------------------------------
<>-----[]--x-----xxxx------------------xxXXXXX----x------xx-----[]---x------------------------------
[]-----[]---x---xx<>-x----------------xxXXXXXX-----x----xx------[]----x------------Exxx----------xxx
[]-----[]-E-Exxxx-[]-ExxxxxxxxxxxxxxxxxXXXXXXX------xxxxx--X----[]-----xxxxxxxxxxxxxx--xxxxxxxxxxxEE
XXXXXXXXXXXXXXXXXXXXXXXXXXXXXXXXXXXXXXXXXXXXXXXXXXXXXXXXXXXXXXXXXXXXXXXXXXXXXXXXXXXXX--XXXXXXXXXXXXX