--------------------------------------------------
--------------------------------------------------
--------------------------------------------------
--------------------------------------------------
------------------------------------------------xx
----------xx-----------------------------------xx-
ES-------xx-x---------------------------------xx--
--------xx---x-------------------------------xx---
-------xx-----x--------------Q--?----------xxx----
------xx-------x----------Q-E------ESSS---xx<>----
-----xxE--------x-----------E------------xx-[]----
----xx<>---------x----------------------xx--[]----
xxxxx-[]--------X-xxxxxxxxxxxxxxxxxxxxxxx---[]----
XXXXXXXXXXXXXXXXXXXXXXXXXXXXXXXXXXXXXXXXXXXXXXXXXX