----------------------------------------------------------------------------------------------------
----------------------------------------------------------------------------------------------------
----------------------------------------------------------------------------------------------------
----------------------------------------------------------------------------------------------------
----------------------------------------------------------------------------------------------------
--------------------------------------------------------------------------------------------------SS
--------------------------------------------------E------------------xxxx--------------------------[
x------------------------------------------------<>-----------------xxXX-x-------------------------[
-x-------------------------------------xxxxxx----[]---xx-----------xxXXX--x----------xxxx----------[
o-x--------------xxx------------------xxXSSS-x---XX--xx-x---------xxXXXX---x--------xx<>-x---------[
---x------------xxX-x----------------xx-X-----x-----xx---x-------xxXXXXX----x------xx-[]--xx-------<
----x-xx------Exx-X--x--------------xx--X------x---xx-SSS-------xxXXXXXX-----x----xx--[]--B-x------x
-X---x--xxxxxxxx--X---xxxxxxxxxxxxxxxE-EX-------xxxx--SSS-xxxxxxxXXXXXXX------xxxxx---[]--b--xxxxxxx
XXXXX---XXXXXXXX--XXXXXXXXXXXXXXXXXXXXXXXXXXX---XXXX--XXXXXXXXXXXXXXXXX--XXXXEXXXXXXXXXXXXXXXXXXXXXX