--------------------------------------------------
xxxxxxxxxx-----xxxx-------------------------------
SSSSSSSSSS-----SSSSSSSSSSSSSSSSSSSSSSSSSSSSSSSSSSS
-------------------------SSSSSSSSS----------------
-------------------------SSSSSSSSS----------------
E------------------------SSSSSSSSS-------oooo-----
>-------------------------------------------------
]-----------------------------xxx--------SSSS-S---
]------------------------xxxxxx--x-----SoS--SoS---
]------------QQQQQ-----xxxXXXXX---x----SSS--SSS---
----SS--SS-----------xxxXXXXXXXXXX-x--------------
X---SS--SS---------xxxXXXXXXXXXXXX--x-------------
X---SS--SSxxxxxxxxxxXXXXXXXXXXXXXXE--xxxxxxxxxxxxx
XX--XX--XXXXXXXXXXXXXXXXXXXXXXXXXXXXXXXXXXXXXXXXXX