--------------------------------------------------
--------------------------------------------------
----------[]--------------------------------------
----------[]---------xxxxx------------------------
----------[]-------xxx----x-----------------------
---------X<>------xx<>-----x----------------------
-----------------xxX[]------x---------------------
SS---------E-----xXX[]-------x-----------xxxxxx---
SS-------------xxxXX[]--------x--xxx---xxx--x--x--
---------xxxx-xx<>XX[]---------xxxS-x-xxXX--X---x-
--------xx---xxX[]XX[]----------x----xxXXX--X----x
-------xx---<>XX[]XX[]----------SS-SSxXXXX--X----X
xxxxxxxx----[]XX[]XX[]--------X-SS-SSXXXXX--X----X
XXXXXXXX----[]XXXXXXXXXXXXXXXXXXXXXX-XXXXX--X----X