----------------------------------------------------------------------------------------------------
----------------------------------------------------------------------------------------------------
----------------------------------------------------------------------------------------------------
----------------------------------------------------------------------------------------------------
----------------------------------------------------------------------------------------------------
----------------------------------------------xxx------------------------------SSSSSSSS-------------
---------------------------------------------xx--x--------------------------------------------------
--------------------------------------------xx----x-------------------------------------------------
------E------------------------------------xx------x-----------------B----------E---E---------------
-----<>-------------------E--S------------xxX--S----x--------B-------b---------SSSSSSSS------xxxxxx-
xxx----------------------<>---------E----xxXXX-------x-------b--?-B------?QQ----------------xx--<>-x
x>-x--------xxxxx------------------<>---xxXXXX---------------B----b--------------o-xxx-----xxX--[]--
<]--xxxxxxxxx----xxxxxxxxxxxxxxxxxxxxxxxxXXXX--------Xxxxxxxxxxxxxxxxxxxxxxxxxxxxxxx--xxxxxxXX--[]--
XXXXXXXXXXXXX---XXXXXXXXXXXXXXXXXXXXXXXXXXXXX--------XXXXXXXXXXXXXXXXXXXXXXXXXXXXXXX--XXXXXXXXXXXXXX