----------------------------------------------------------------------------------------------------
----------------------------------------------------------------------------------------------------
-------?--------------------------------------------------------------------------------------------
----------------------------------------------------------------------------------------------------
-----------------------xxxxx------------------------------------------------------------------------
--------------xxxxx---xxXX--x---------------------------------------------------------------xxx-----
---------SS--xx----x-xxXXX---x-------------------------------------------------------------xxX-x----
------------xxX-----xxXXXX----x-----------------------------------------------------------xxXX--x---
-----SS----xxXX------xXXXX-----x--------------------B--------------------xx--------------xxXXX---x--
----------xxXXX------XXXXX------x-----------B-------b-------------xxxx--xx-x------------xxXXXX----x-
xxx------xxXXXX-----XXXXXX-------x----------b--?-B------?QQ?-----xx---xxx---x----------xxXXXXX-----x
<>-x---xxxXXXXX----XXXXXXX--------xx--------B----b--------------xx-----x-----xx-------xxXXXXXX------
[]--xxxx-XXXXXX---XXXXXXXX--------X-xxxxxxxxxxxxxxxxxxxxxxxxxxxxxX-----X-----X-xxxxxxxxXXXXXXX------
XXXXXXXX-XXXXXXXXXXXXXXXXXXXXXXXXXXXXXXXXXXXXXXXXXXXXXXXXXXXXXXXXX-----X-----XXXXXXXXXXXXXXXXXXXXXXX