--------------------------------------------------
--------------------------------------------------
--------------------------------------------------
--------------------------------------------------
--------------------------------------------------
----------------------QQQQQ------------SSSS-------
S-------------------------------------------------
--------------------------------------------------
--------------xxxx-------------------------xxxx---
-------------xx<>-x--E?QQQQ-----------S---xx<>-x-Q
xxxxxxxx----xx-[]--x---------------------xx-[]--x-
XXXXXXX-x--xx--[]---x-------------------xx--[]---x
X--------xxx---[]----xxxxxxxxxxxxxxxxxxxx---[]----
X--------XXXXXXXXXXXXXXXXXXXXXXXXXXXXXXXXXXXXXXXXX