----------------------------------------------------------------------------------------------------
----------------------------------------------------------------------------------------------------
-----SSS--[]SSSSSSSSSS---------------------------------------------SSSSSSSSSSSSSSSS-------------SSS-
----------[]SSSSSSSSSS-------------------XXXXXXXXXXXXooX--------x--SSSS-----------------------------
x---------[]SSSSSSSSSS------------------XX-----------------------x-SSSS-----------------------------
-x--------[]SSSSSSSSSS-----------------XXX------------------------xSSSS-------------xx--xxxxx-------
E-x-------[]SSSSSSSSSS----------------XXXX-------------------------x---------------xx-xxx----x------
---x------[]SSSSSSSSSS---------------XXXXX--------------------------x-------------xx--XXX-----x-----
----x------]SSSSSSSSSS--------------XXXXXX--------------------X-----oxxx------xxxxx------------x----
-----xxxxx-]SSSSSSSSSS--------E----XXXXXXX-------------------------S?SS-x----xx-XXX-------------xxxx
SSS--SSSSSSSSSSSSSSSSS---E---<>---XXXXXXXX-----<>------>---X-------SSS---x--xx-----------SSS-S--SSSS
SSS--SSSSSSSSSSSSSSSSS--<>---[]--XXXXXXXXX-----[]------]---X-------SS-----xxx------------SSS-S--SSSS
SSS--SSSSSSSSSSSSSSSSS--[]---[]-XXXXXXXXXX-----[]------]---X---------E-EE--xX------------SSS-S--SSSS
XXXXXXXXXXXXXXXXXXXXXXXXXX---XXXXXXXXXXXXXXXXXXXXXXXXXXXXXXX----XXXXX-XXXXXXX---------XXXSSS-S--XXXX