--------------------------------------------------
--------------------------------------------------
--------------------------------------------------
--------------------------------------------------
--------------------------------------------------
-------------------------------------QQQQ---------
--------oooo------------oooo----------------------
--------------------------------------------------
----xxxx------------xxxx--------------------------
---xx<>-x----------xx<>-x----------QQ?SSQQQ-------
--xx-[]--x--------xx-[]--x------------------------
-xx--[]---x------xx--[]---x----------xxx----------
xx---[]----xxxxxxx---[]----xxxxxxxxxxx--xxxxxxxxxx
XXXXXXXXXXXXXXXXXXXXXXXXXXXXXXXXXXXXXX--XXXXXXXXXX