----------------------------------------------------------------------------------------------------
----------------------------------------------------------------------------------------------------
----------------------------------------------------------------------------------------------------
----------------------------------------------------------------------------------------------------
----------------E-----------------------------------------------------------------------------------
-----------SSSSSSS----S-----------------------------------------------------SSS---------------------
----------------------------------------------------------------------------------------------------
----------------------------------------------------------------------------------------------------
-------------E--------------------------xxxxx-------------------xxx---xxxxx-----------------------xx
-----------SSSSSSS---xxxx-------------xxx----x-------------xxxxxxS-xxxx-XX-xSSS------------------xxX
-----xxxx-----------xx<>-x-----------xx<>-----xx---------xxx---xS-SSX<>-XX--x-------------------xxXX
x---xx<>-x---------xx-[]--x-------B-xx-[]----<>-x---B---xx<>--XXS-SSX[]-XXX--x---------------B-xxXXX
Xxxxx--]--xxxxxxxxxx--[]---xxxxxxxxxx--[]-E--[]--xxxxxxxx-[]--XXS-SSX[]-XXX---xxxxxxxxxxxxxxxxxxXXXX
XXXXXXXXXXXXXXXXXXXXXXXXXXXXXXXXXXXXXXXXXXXXXXXXXXXXXXXXXXXXXXXXSXX-XXXXXXXXXXXXXXXXXXXXXXXXXXXXXXXX