----------------------------------------------------------------------------------------------------
--------------------------------xxxxxxxxxxxxxxxxxxxxxxxxxxxxxxxxxxxxxxxxxxxxxxx--------------xxxxxxx
SSSSSSSSSSSSSSSSSSSSSSS--------xxSSSSSSSSSSSSSSSSSSSSSSSSSSSSSSSSSSSSSSSSSSSSS-x-----SSSS---xxSSSSSS
------------------------------xx------------------------------------------------x----------xx-------
-------------------------XXX-xx--------------------------------------------------x----?---xx--------
------------------------xxxx-xSSS------------E------------------------------------x--S??-xx---------
-----xxxxxx------------xx---xx--------------<>-------------------------------------x----xxXXX-------
-xxxxx-SSS-x----------xx-----xS------XX-----[]--------------------------------------x--xx-----------
xx--<>------x-----xxxxx------S-S------------[]-------S--------------------E----------xxx------------
??--[]-------x---xx-XXX---------S------E--SS[]SS---E----E--------------X-<>------XXX-SSSS-----------
S---[]--------x-xx--------------------<>----[]----<>---<>-------------XX-[]--XXX------------------E-
S---[]---------xx---------------------[]----[]----[]---[]------------XXX-[]--XXX-----------------<>-
>---[]--------XXX---------------------[]-E--[]----[]---[]--------E-E-XXX-[]--XXX-----------------[]-
XXXXXXXXXXXXXXXXX------------XXXXXXXXXXXXXXXXXXXXXXXXXXXXXXXXXXXXXXXXXX--XX--XX------XXXX------XXXXX