----------------------------------------------------------------------------------------------------
-------------------------------------------------------------------------------xx--------xx---------
------------------------------------------------------------------------------xx-x------xx-x--------
-----------------------------------------------------------------------------xx---x----xx---xx------
---------------xxx--------oo-----------------------------------------xxxxxxxxx-----xxxxx------x-----
--------------xx--x--------------------------------------------------xSSSSSSSS-----SSSSS-------x----
-------------xx----x-------------------------------------------------x--------------------------x---
------------xx------x------------------------------------------------x-------------<-------------x--
----------xxx--o-----xxx--------------------------------------------xx-------------[------------E-x-
---------xx<>--------<>-x------------------------------xxxx--------xxX----S--ES----[---ES------<>--x
xxxxx---xx-[]--------[]--x-----xxxx-------------------xx<>-x------xx-X------<>--------<>------E[]---
<><>-x-xx--[]--------[]---x---xx<>-x-----------------xx-[]--x----xx--X------[]--<>----[]--<>-<>[]---
[][]--xx---[]--------[]-E-Exxxx-[]-Exxxxxxxxxxxxxxxxxx--[]---xxxxxE--X------[]--[]----[]--[]-[][]---
XXXXXXXXXXXXXXXXXXXXXXXXXXXXXXXXXXXXXXXXXXXXXXXXXXXXXXXXXXXXXXXXXXXXXXXXXXXXXXXXXXXXXXXXXXXX-XXXXXXX