----------------------------------------------------------------------------------------------------
----------------------------------------------------------------------------------------------------
----------------------------------------------------------------------------------------------------
----------------------------------------------------------------------------------------------------
----------E-----------------------------------------------------------------------------------------
------SSSSSS----S----------------------------------------------------------------------------------S
-----------------------------------------------------------xxxx-------------------------------------
----------------------------------------------------------xx---x----------------------------------E-
-------E-------------------------xxxxx---------------xxx-xx-----xxx-------xxxx----S-----------------
xx---SSSSSSS---xxxx------------xxx----x-------------xx--xx------<>-x-----xx<>-x-----------------S?S-
>-x-----------xx<>-x----------xx<>-----xx---------xxx---<>------[]--x---xx-[]--x--------------------
]--x---------xx-[]--x------B-xx-[]----<>-x---B---xx<>---[]------[]---x-xx--[]---x-----xxx-----------
]---xxxxxxxxxx--[]---xxxxxxxxx--[]-E--[]--xxxxxxxx-[]---[]-E----[]----xx-E-[]----xxxxxx--xxxxxxxxxxx
XXXXXXXXXXXXXXXXXXXXXXXXXXXXXXXXXXXXXXXXXXXXXXXXXXXXXXXXXXXXXXXXXXXXXXXXXXXXXXXXXXXXXXX--XXXXXXXXXXX