----------------------------------------------------------------------------------------------------
----------------------------------------------------------------------------------------------------
----------------------------------------------------------------------------------------------------
----------------------------------------------------------------------------------------------------
-----------------------------------------------------------xxxx-------------------------------------
------SSSSSS--------------xxxxx---------------------------xxXX-x------------------------------------
----E--------------------xx-<>-x-------------------------xxXXX--x-----------------------------------
-----xxxxx--------------xx--[]--x-----------------------xxXXXX---x----------------------------------
---xxx----xx----------xxx---[]---x---------------------xxXXXXX----x-----S-S?------------------------
--xx<>---<>-x--------xx<>--QQQ?---x-------------------xxXXXXXX-----x--------------------------------
-xx-[]---[]--x------xx-[]----------x--------xxxx-----xxXXXXXXX------x------------------------xxx----
xx--[]---[]---x----xx--[]-----------x------xx<>-x---xxXXXXXXXX-------x------xxx------xxx----xxX-x---
x---[]---[]----xxxxx---[]------E-----xxxxxxx-[]--xxxxXXXXXXXXX--------xxxxxxx--xxxxxxx--xxxxx----xxx
XXXXXX---XX--XXXXXXXXXXXXX-----X---XXXXXXXXXXXXXXXXXXXXXXXXXXXXXXXXXXXXXXXXXX--XXXXXXX--XXXXXXXXXXXX