--------------------------------------------------
--------------------------------------------------
--------------------------------------------------
--------------------------------------------------
------------------------------------E-------------
------------------------xxxx-------SQS--SQS-------
-----------------------xxXX-x---------------------
-------------------xxxxxXXX--x--------------------
?-----------------xx--xXXXX---x-------------------
---ESSS----------xx---XXXXX----x---SQS--S?S-------
----------<E----xx----XXXXX-----x---------------E-
E---------->---xx-----XXXXX------x----------------
xxxxxxxxxxxxxxxxX-----XXXXX------Exxxxxxxxxxxxxxxx
XXXXXXXXXXXXXXXXX-----XXXXXXXXXXXXXXXXXXXXXXXXXXXX