-X--------xxxxx-----------------------------------
xxxxx-xxxxx----x------xx--------------------------
SSSS-xSSSSS-----x----xx-x-------------------------
----<>-----------x--xx---x-----xxx----------------
----[]------------xxx-----xxxxxx--x---------------
E---[]------------XXX-----XXXXXXE--x--------------
>-----------------------------------x-------------
]------------------------------------x------------
]-------------------------------------x----xx-----
]--------------------------------------x--xx-x---x
]---------------------------------------xxx---x-xx
]----------------------------------------x-----xx-
]--------------------------------XXXXEXXEX-----XX-
XX---------XXXXX----------------------------------