----------------------------------------------------------------------------------------------------
xxxxxxx---------------------------------------------------------------------------------------------
SSSSSS----SSSSSSSSS?SSSSSSSSSSSSSSSSSSSSSSSSSSSSSSSSSSSSSSS----[---------------------SSSSSSSSSSSSSSS
------<-------------------------------------------------------XXX-------------------------SSS------[
------[-----------------------------------------------------------------------------------SSS------[
-E----[x-------------------------------------------------------------E----------------SSSSSSS------[
->------x----------xxx------xx--------------------------------------<>-----------------------------[
-]-------x----xxxxxx--x----xx-x-xxx---------------------------------[]-----------xxxxxxxxxx--------[
<]--------x--xxXXXXS---x--xx---xx--x---------------------xxxxxxx----XXX--------xxx----x----xx------[
[]---------xxxXXXXXX----xxx----<>---x------xxxx---------xxXXX-x-x-------------xx<>---SS---<>-x-----[
[]----------xXXXXXXX-----<>----[]----xxx--xxSS-x-------xxEXXX-X--x-----xxx---xx-[]--------[]--x----<
[]---------XXXXXXXXX-----[]----[]----<>-xxx-SS--x-----xxXXXXX-----x---x<>-x-xx--[]--------[]---x----
[]--------XXXXXXXXXX-----[]----[]--E-[]--x--SS---xxxxxxXXXXXX------xxxx[]--xx---[]--------[]----xxxx
XXXXX-----XXXXXXXXXX--XXEXXXXXXXXXXXXXXXXX--XX--XXXXXXXXXXXX------XXXXXXXXXXXXXXXXXXXXXXXXXXXXEXXXXX