----------------------------------------------------------------------xxx---------------------------
---------------------------------------------------------------------xx--x----xxx-------------------
--------------------------------------------------------------------xx----x--xx--x------------------
--------------------------------------------------------------xxxxxxx------xxx----xx----------------
-------------------------------------------------------------xx----x--------x-----E-xxxxxx----------
--------xx---------------------------SSSSSS-----SSSSS--------xX----E--------?--------x----x-------SS
x------xx-x-------------------------S------------[]---------xx----<>----------------<>-----x--------
-x----xx---xxx---------------------SS------------[]---------x-----[]----------------[]------xxxx----
--xxxxx-----x-x-------------------SSS--------?---[]-------xxx-----[]----------------[]-------xB-xxxx
--XXXXX-----S--xS----------------SSSS------------<>------xx<>-----[]----------------XX-------XXXXESS
----------------x---------------------------------------xx-[]-----[]------------------------XXXXXX--
oo---------------x------xxx-----xxx-----------xxx-E----xx--[]-----[]-----------------------XXXXXXX--
oo----------------xxxxxxxE-xxxxxxB-xxxxxxxxxxxxB-xxxxxxx---[]-----[]------E---------------XXXXXXXX--
XX----------------XXXXXX<>XXXXXXXXXXXXXXXXXXXXXX-XXXXXXXEXXXX-----XXXXXXX<>XXXE-----------XXXXXXXXXX