----------------------------------------------------------------------------------------------------
----------------------------------------------------------------------------------------------------
----------------------XXXX--------------------------------------------------------------------------
-----------------------[]---------------------------------------------------------------------------
-----------------------[]---------------------------------------------------------------------------
-----------------------<>------xx-x-------------------------------------------E-E-E-----S---SSSSSSSS
------------------------------xx]<-x-----------------------------------------<><><>-----------------
------------------------E-----xX][--x--------------xxxxx---------------------[][][]-----------------
----------------------------xxxX-[---x----------xxxx-<>-x----------------Q?--QQQQQQ--------------xxx
------xxxx------------xxxx-xx<>X-EE---x--------xxQQ?-[]--x----------------------------E---------xx--
B----xx---xxxxx------xx---xx-[]X<>>----x------xx-----[]---x----------------------------xxxx----xx---
b---xx----XXXX-x----xx---<>X-[]X[]]-----x----xx------[]----x--------------xxx---------xx<>-x--xx----
xxxxx-----------xxxxx----[]XX[]X[]]------xxxxx--X----[]-----xxxxxxxxxxxxxxx--xxxxxxxxxx-[]--xxx-----
XXXXX-----------XXXXX----[]XXXXXXXXXXXXXXXXXXXXXXXXXXXXXXXXXXXXXXXXXXXXXXXX--XXXXXXXXXXXXXX-XXX-----