--------------------------------------------------
---------------------------------------------xxx--
SSSSSSSSSSSS?SSSSSSSSS----------------------xx--x-
-------------------------------------------xx----x
------------------------------------------xx-----E
----------ooo-------------S----S--------xxxS------
---------------------------------------xx-Sx------
--------S-SSS-------------------------xx----------
xxx-----SoS--------------xxxx--------xx-----------
xE-x----SSS---------SS--xx<>-x------xx------------
<>--x---------------SS-xx-[]--x----xxE------------
[]---x--------------SSxx--[]---x--xx<>------X-----
[]----xxxxxxxxxxxxxxxxx---[]----xxx-[]-----XX-----
XXXXXXXXXXXXXXXXXXXXXXXXXXXXXXXXXXXXXXXXXXXXXS----