----------------------------------------------------------------------------------------------------
----------------------------------------------------------------------------------------------------
----------------------------------------------------------------------------E-----------------------
----------------------------------------------------------------------------------------------------
Q---------------------------------------------------------------------------------------------------
------------------------------------------------------------------SSSSSSSSSSSSS-------------------SS
----------------------------------------------------------------------------------------------------
----------------------------------------------------------------------xxxxxxx-----<>----------------
------------B-----------------B-------------------------------------xxxSSSSS-x----[]----------------
------------b-----------------b-----------------------------------xxxSS-------x--QQQQQQQ----------SS
----?-B--B-----?QQ-------B-------?QQS----------------------------xx<>----------x--------------------
x-----b--b---------------b----------------------xxx------xxxxx--xx-[]-----------x-xxxxx---xxx-------
-xxxxxxxxxxxxxxxxxxxxxxxxxxxxxxxxxxxxxxxxxxxxxxxx--xxxxxxx----xxx--[]----E---EE--xx----xxxxE-xxxxxxx
XXXXXXXXXXXXXXXXXXXXXXXXXXXXXXXXXXXXXXXXXXXXXXXXX--XXXXXXX--X-XXXXXXXXXXXXXXXXXXXXX-X-XXXXXXXXXXXXXX