----------------------------------------------------------------------------------------------------
------------------------------------------------------------------------------------------xxx-------
-----------------------------------------------------------------------------------------xx--x------
----------------------------------------------------------------------------------------xx----xx----
----------xxxxxxxxxxx----------E-E------------------xxxxx------------------------------xx-----E-xxxx
---------xx--QQQ?QQQ-x-------SSSSSSS-SS-xxxx-----xxxx--X-x--------------------xxxxxxxxxx---------x--
--------xx------------x-------------E--xx---x---xx--E--X--x------------------xx-SSSSSSSS-X------<>--
-------xx------E-------x--------------xx-----x-xx---XX-X---x----------------xx------------------[]--
-xxxxxxx-----SSSSSSS----x-----------xxx-------xx----XX-X----x-------------xxx--Q----------------[]--
xx----<>--------------E--x---------xx<>-------<>----XX-X-----x-----------xx<>------E------------XX--
<>----[]-------X------X---x---E---xx-[]-------[]----XX-X------x---------xx-[]-----<>----------------
[]----[]-------X------X----x-----xx--[]-------[]----XX-X-------x-------xx--[]-----[]----------------
]]----[]----E--X------X-----xxxxxx---[]-------[]----XX-X-------Xxxxxxxxx---[]-----[]---X------------
XX-EXXXXXXXXXXXXXXXXXXXXXXXXXXXXXXXXXXX-------XX-XXXXX-XXXXXXXXXXXXXXXXXXXXXXXXXXXXXXXXX------------