----------------------------------------------------------------------------------------------------
----------------------------------------------------------------------------------------------------
----------------------------------------------------------------------------------------------------
----------------------------------------------------------------------------------------------------
---------------------------------------------------------------------------------------xxxxxxxxxxx--
----------------------------SSSSSSSSSSSSS-------------------SSS?SSS-------QQ?---------xx--QQQ?QQQ-x-
-------------------------------------------------------------------------------------xx------------x
xx------------------------------xxxxxxx-----<>--------------------------------------xx------E-------
>-x---Q--Q--?-----------------xxxSSSSS-x----[]----------------------------SSS-----xxx-----SSSSSSS---
]--x--------------S---------xxxSS-------x--QQQQQQ-----------SSSSSSS------xxxx----xx<>--------------E
]---x-----------E----------xx<>----------x------------------------------xx---x--xx-[]-------X------X
]----x------E-----xxxxxx--xx-[]-----------x-xxxxx---xxx---------xxxxxxxxx-----xxx--[]-------X------X
]-----xxxxxxxxxxxxx---X-xxx--[]----E---EE--xx----xxxxE-xxxxxxxxxx---x--x-------x---[]----E--X------X
XXX-XXXXXXXXXXXXXXX---XXXXXXXXXXXXXXXXXXXXXXX-X-XXXXXXXXXXXXXXXXX-X-X--X-------XXXXXXXXXXXXXXXXXXXXX