----------------------------------------------------------------------------------------------------
----------------------------------------------------------------------------------------------------
----------------------------------------------------------------------------------------------------
---------o--------------------------------------------------------o---------------------------------
----------------------------------xxxxxxxxxxx-------------------------------------------------------
-------SSS-------E---------------xx--QQQ?QQQ-x------------------SSS-------E----------------------E--
->--------------<>--------------xx------------x--------------------------<>---------------------<>--
----xxxxxxxxx---[]-------------xx------E-------x-------------xxxxxxxxx---[]---------------------[]--
-xxxx---x----xx-XXX----------xxx-----SSSSS-S--E-x----------xxx---x----xx-XXX----------xxxx------[]--
xx-<>---S---<>-x------------xx<>----------E--<>--x--------xx<>---S---<>-x------------xx<>-x----SXXS-
<>-[]-------[]--x-xxxxxx---xx-[]-------X--]--[]---x------xx-[]-------[]--x-xxxxxx---xx-[]--xx------x
[]-[]-------[]---xx<><>-x-xx--[]-------X--]--[]----x----xx--[]-------[]---xx<><>-x-xx--[]-<>-x----xx
[]-[]----E--[]----x[][]--xx---[]----E--X--]--[]-----xxxxx---[]----E--[]----x[][]--xx---[]-[]--xxxxx-
XXXXXXXXXXXXXXXXXXXXXXXX-XXXXXXXXXXXXXXXXXXXXXXXXXXXXXXXXXXXXXXXXXXXXXXXXXXXXXXXXXXXXXXXXXXXXXXXXXXX