----------------------------------------------------------------------------------------------------
-------------------------------------------------------xx-x-----------------------------------------
--------------------------------------------------------xx-x--------------------------------SSSSSSSS
------------------------------------------xxx---------------x------xxxxxxx--------------------------
---------xxx--------------------xxxx----xxx--x---------------x-xxxxx------x---------------------xxxx
--------xx--x----------------E-xx---x--xxXS---x---------------xx--XX-------x-------------------xx---
------xxx----x----------------xx-----xxxEX-----x--------------XX------------x-----------------xx----
---xxxxx------x--------------xx-------xXXX------x----------------------------x------------xxxxx-----
--xx--E--------x-----------xxx--------XXXXS------x----------------------E-----x----------xx--xE-----
-xx------X------x---------xx<>-------XXXXX--------xx---x---------------<>----E-x--------xx---<>-----
xx-----------E---x-------xx-[]------XXXXXX------------xx---------------[]---<>--x-----xxx----[]-----
x-----------------xxx---xx--[]-----XXXXXXX-----------xx----------------[]---[]---x---xx<>----[]----<
X-----------------XX-xxxx---[]----XXXXXXXX----------xx-----------------[]---[]----xxxx-[]----[]----[
X----------------XXXXXXXXXXXXXXXXXXXXXXXXXXXXXXXXX-xx------------------[]---[]----XXXXXXXXXXXXXXXXXX