----------------------------------------------------------------------------------------------------
----------------------------------------------------------------------------------------------------
----------------------------------------------------------------------------------------------------
----------------------------------------------------------------------------------------------------
----------------------------------------------------------------------------------------------------
-----------------------------------xx-----------------------SSSQ--------------?---------------------
----------------------------xxxx--xx-x-------------------S------------------------------------------
---------------------------xx---xxx---x----oooooo----------------------------------------------xxx-X
-------------x------------xx-----x-----x-----xx-----------------------------------------------xxXx-X
xx----------E>-------xxxxxx------X------x---xx-x---------------S-----SS----Q--Q--------------xxXX--X
B-x-----------------xxE--x-------XX------x-xx---x-------------------------------B------E---ExxXXX-xX
b--x----xxx--------xx<>-XX-------XXX------xx-----xxx----------------------------b----------xxXXXX--x
B-E-xxxxx--xxxxxxxxx-[]-XXX------XXXX-----<>-----XX-xxxxxxxxxxxxxxxxxxxxxxxxxxxxxxxxxxxxxxxxXXXXX---
XXXXXXXXX--XXXXXXXXXXXXXXX-------XXXXX----[]------XXXXXXXXXXXXXXXXXXXXXXXXXXXXXXXXXXXXXXXXXXXXXXXXXX