----------------------------------------------------------------------------------------------------
----------------------------------------------------------------------------------------------------
----------------------------------------------------------------------------------------------------
----------------------------------------------------------------------------------------------------
----------------------------------------------------------------------------------------------------
----------------------------------------------------------------------------------------------------
----------------------------------------------------------------------------------------------------
--------------------------------------------------------------------------------------?-------E-----
---------------------B-----------------------------------SSSSS---------------------xxx--------------
?QQQQ----------------b------------------------------------------------------------xx--xxxxxxxxxxxx--
--------B-----E---B------?QQ-----------------------------------------------xxx---xx---XXXXXXXXXXX-x-
E-------b---------b----------------------xxx-----xxxx-------------xxx-----xxX-xxxx----X---------X--x
xxxxxxxxxxxxxxxxxxxxxxxxxxxxxxxxxxxxxxxxxx--xxxxxx---xxxxxxxxxxxxxx--xxxxxx-X-XXXX----X---------X---
XXXXXXXXXXXXXXXXXXXXXXXXXXXXXXXXXXXXXXXXXX--XXXXXX--XXXXXXXXXXXXXXX-XXXXXXXXXX------------------X---