----------------------------------------------------------------------------------------------------
----------------------------------------------------------------------------------------------------
SSS--S-SSSSSS---------S-----------------------------------------------------------------------------
----------------------------------------------------------------------------------------------------
---------------xxxx--------------------------------------xxxxxxxx-----------------------------------
----Q---------xx---xSSS--------xxx----------------------xx-SSSSS-x-------------------QQQQQ----------
-------------xx-----x--xxxxxxxxx--x-----------SSS------xx---------x---------------------------------
-?----E---E-xx-------xxxXXXXXXXX---x------------------xx-----------x--------------------------------
x-----xxxxxxx---------xXXXXXXXX-----x----------------xxX------------x--------xxxx-------------------
BxxxxxxXXXXXX---------XXXX-----------x---------?S---xxEX---S------X--x------xx<>-x--E?QSQQ----------
bXXXXXXX-------------XXXXX------------x------------xxXXX----------X---x----xx-[]--x-----------------
XXXXX---------------XXXXXX-------------xx---------xxXXXX----------XX---x--xx--[]---x----------------
XXXX---------------XXXXXX----<>-------XX-xxxxxxxxxxXXXXX----EE----XX---Exxx---[]----xxxxxxxxxxxxxxxx
XXXX---------------XXXXXX----[]-------XXXXXXXXXXXXXXXXXXXXXXXXXXXXXXXXXXXXXXXXXXXXXXXXXXXXXXXXXXXXXX