----------------------------------------------------------------------------------------------------
----------------------------------------------------------------------------------------------------
-------------------------------------------------------------------------------SS-------------------
-------------------------------------------------------------------------------[]-------------------
x------------------------------------------------E-------------E---------------[]-------------------
-x---------------------------------------------SSSSSSS----SSSQ-----------------<>-------------------
--x----xxxxx----------------------------------------------------------------------------------------
--Exxxxx----x---------------------------------E---------------------------------E-------------------
---XXXXX-----xxx-------xxxx----S---------------------------------------------xxxx-------------------
Q------------<>-x-----xx<>-x----------------S?S--------------S--------------xx<>-x-QQQQQ?QQQQQ?QQQQQ
------<>-----[]--x---xx-[]--x----------------------------------------------xx-[]--x-----------------
------[]-----[]---x-xx--[]---x-----xxx--------------xxxxx-----------------xx--[]---x----------------
------[]-----[]----xx-E-[]----xxxxxx--xxxxxxxxxxxxxxx----xxxxxxxxxxxxxxxxxx---[]----xxxxxxxxxxxxxxxx
X-----XX-----XXXXXXXXXXXXXXXXXXXXXXX--XXXXXXXXXXXXXXX---XXXXXXXXXXXXXXXXXXXXXXXXXXXXXXXXXEXXXXXEXEXX