----------------------------------------------------------------------------------------------------
----------------------------------------------------------------------------------------------------
----------------------------------------------------------------------------------------------------
----------------------------------------------------------------------------------------------------
----------------------------------------------------------------------xxxxxxx-----------------------
----Q----------------------------------------------------------------xx-SSSS-x-------------------QQQ
-----------------------xxxx-----------------------------------------xx--------x---------------------
----------------------xx---x---------------------------------------xx----------x--------------------
---------------------xx-----xxx-------xxxx----S-------------------xxX-----------x--------xxxx-------
--S?SQS------------xxx------<>-x-----xx<>-x----------------S?S---xxEX---S-----X--x------xx<>-x--E?QQ
---------xxxx-----xx<>------[]--x---xx-[]--x--------------------xxXXX---------X---x----xx-[]--x-----
--------xx<>-x---xx-[]------[]---x-xx--[]---x-----xxx----------xxXXXX---------XX---x--xx--[]---x----
xxxxxxxxx-[]--xxxx--[]-E----[]----xx-E-[]----xxxxxx--xxxxxxxxxxxXXXXX----EE---XX---Exxx---[]----xxxx
XXXXXXXXXXXXXXXXXXXXXXXXXXXXXXXXXXXXXXXXXXXXXXXXXXX--XXXXXXXXXXXXXXXXXXXXXXXXXXXXXXXXXXXXXXXXXXXXXXX