----------------------------------------------------------------------------------------------------
----------------------------------------------------------------------------------------------------
----------------------------------------------------------------------------------------------------
----------------------------------------------------------------------------------------------------
----------------------------------------------------------------------------------------------------
-----------------------------------------------------SSSSSS--------------xxxxx----------------------
---------------------------------------------------E--------------------xx-<>-xx--------------------
----------------------------------------------------xxxxx--------------xx--[]-X-x------------------x
--------X-----------------------------------------xxx----xx----------xxx---[]-X--x-----xx---------xx
E---ESSSX------------------------xxxx------------xx<>---<>-x--------xx<>--QQQ?X---x---xx-x-xxxxxxxx-
>-------------------------------xx---xx---------xx-[]---[]--x------xx-[]------X----x-xx---xx---QQQ?-
----------------------xxxxx----xx---<>-x-------xx--[]---[]---x----xx--[]------X-----xx----<>--------
xxxxxxxxxxxxxxxxxxxxxxxE---x--xx----[]--xxxxxxxx---[]---[]----xxxxx---[]------X-----<>----[]--------
XXXXXXXXXXXEEXEXXXXXXX<>----xxx-----XXXXXXXXXXXX--XXX---XX--XXXXXXXXXXXXX-----X-----[]----[]--------