--------------------------------------------------
--------------------------------------------------
SSSSSSSSSSSSSSSSSSSSSSSSSSSSSSSSSSSSSSSSSSSSSSSSSS
---------------------------------------------SSSSS
--------------------xxx----------------------SSSSS
-------------xxxxxxxx--x---------------------SSSSS
------------xxSSSSSSS---xxxxx---------------------
-----E-----xx-SSSSSSS--SSSSS-x--------------------
xxxxxxxxxxxx--SSSSSSS--SSSSS--xxxxxxxxxxxxxxxxxxxx
SSSSSSSSSSSS--SSSSSSS--SSSSS?SS?SSSSSS???????SSSSS
SSSSSSSSSSSS-------------------SSSSSSSSSSSSSS-----
SSSSSSSSSSSS---------<>--------SSSSSSSSSSSSSS-----
SSSSSSSSSSSS---------[]---------------------------
XXXXXXXXXXXXXXXXXXXXXXXXXXXXXXXXX-XXX-XXXXXXXXXXXX