----------------------------------------------------------------------------------------------------
----------------------------------------------------------------------------------------------------
----------------------------------------S-S--------------SSSSSSSSSSSSSSSS-------S-------------------
----------------------------------------------------------------------------------------------------
------------------------------E---------------------------------------------------------------------
----------------------------SSSSSSSS---SSSQ--------------?------------------------------------------
-----------------------------------------------------------------------------------------ES---------
---------------------------E---------------------------------------------------S---------------QQQ--
-------SSS--------------------------------------------------------------------XS--------------------
-------------------------S?S--------------S-----SS----Q--Q--QQS-------xxxxx---XSSS------------------
Q-------------------------------------------------------------------ExxSSS-x----SS-xx---------------
xxx------xxx---xxx---------------xxxxx--------------------------B---xx-SSS--x---SSxB-x-----------xxx
---xxxxxxx--xxxx--xxxxxxxxxxxxxxxx----xxxxxxxxxxxxxxxxxxxxxxxxxxxxxxx--SSS---xxxxxxb--xxxxxxxxxxxxB-
X-XXXXXXXX--XXXX--XXXXXXXXXXXXXXXX---XXXXXXXXXXXXXXXXXXXXXXXXXXXXXXXXXXXXX---XXXXXXXXXXXXXXXXXXXXXX-