---------------------------------------------------------------------------------X------------------
---------------------------------------------------------------------------------X------------------
SSSS-SSSSSSSSSSSSSSSSSSSSSSSSSSSSSSSSSSSSSSSSSSSSS-------------SSS-[]SSSSSSSSSSSSSS-----------------
SSS------------SSSSSSSSSSSSSSSSSSSSSSSSSS--------------------------[]SSSSSSSSSSSSSS-----------------
SSS------------SSSSSSSSSSSSSSSSSSSSSSSSSS-----------XXX------------[]SSSSSSSSSSSSSS-----------------
SS-E-----------SSSSSSSSSSSSSSSSSSSSSSSSSS--QQ------xxxxxxxxx-------[]SSSSSSSSSSSSSSS-----------oo---
SS<>----------------------------------------------xx---x----x------[]SSSSSSSSSSSSSSS----------------
SS[]------------------xxx---------------xxx-xxx--xx----X-----x-----[]SSSSSSSSSSSSSSS----------------
SS[]----------xxxxxxxxx?-xxxxxxxxxxxxxxxx--xx--xxx------------x-----]SSSSSSSSSSSSSSS----------SS----
SSSQ?--------xx-SSSSSSS??SSSSSSSSSSSSSSSS--QQ--QQQ-------------xxxx-]SSSSSSSSSSSSSSS--------E------?
-SS---------xx--SSSSSS---SSSSSSSSSSSSSSSS---------------SSS-S--SSSSSSSSSSSSSSSSSSSSS-------<>-------
-SS-xxx----xx---SSSSSSoooSSSSSSSSSSSSSSSS---------------SSS-S--SSSSSSSSSSSSSSSSSSSSS-------[]-------
xxxxx--xxxxx----------oooSSSSSSSSSSSSSSSS---------------SSS-S--SSSSSSSSSSSSSSSSSSSSS---<>--[]-------
XXXXX--XXXXX---XXXXXXXXXXXXXXXXXXXXXXXXXXXXXXXXXXX------SSS-S--XXXXXXXXXXXXXXXXXXXXX---[]--[]-------