----------------------------------------------------------------------------------------------------
----------------------------------------------------------------------------------------------------
S---SSSSSSSSSSSSSSSSSSSSSSSSS-SSSSSSSSSSSSSSSSSSSSSSSSSSSSSSSSSSSSSSSSSSS?SSSSSS-SSSSSSSSSSSSSSSSSSS
-------------------------------------SS--SSSSSSS--SSSS------SSSS------------------------------------
-xxxxxxxxx---------------------------SS--SSSSSSS--SSSS--E---SSSS------------------------------------
-x--QQQQX-x-------------oooo-------SS---------SS---S----SS----------oooooo--------------------------
xx---------x-----------------------SS---------SS---S----SS-----------------------------xx-----------
x---SSSSS---x---------SSSSSS-S-----SS---------SS---S----SS----------SSSSSS------------xx-x-xxx------
S---SSSSS----x--------SSS--SoS-----SS----oooooSS---So??-SS---E------SSSSSS-----------xx---xx--x-----
S---S---------x-------SSS--SSS-----SSSS--SSSSSSS---SSS--SS--SSSS-------------------xxx----<>---x-xxx
S--------------x---------------------SS--------------------EE---------------------xx<>----[]----xxSS
S---------------xx-------------------SS----oo------------------xxxxx-------------xx-[]----[]----<>SS
----------------X-xxxxxxxxxxxxxxxxxxxxxxxxxxxxxxxxxxxxxxxxxxxxxx----xxxxxxxxxxxxxx--[]----[]--E-[]SS
XXXXXXXXXXXXXXXXXXXXXXXXXXXXXXXXXXXXXXXXXXXXXXXXXX-XXXXXXXXXXXXX---XXXXXXXXXXXXXXXXXXXXXXXXXXXXXXXXX