----------------------------------------------------------------------------------------------------
----------------------------------------------------------------------------------------------------
----------------------------------------------------------------------------------------------------
----------------------------------------------------------------------------------------------------
-------------oo--------------------------------------------------------xxxxxx-----------------------
---xxx----------------------------------------------------------------xx?SSS-x----------------------
--xx--x---------------------------------------------------------------x-------x---------------------
xxx----x---------------------------------------------------------xxxxxx-------Ex--------------------
-x------xxx-----------------------------------------------------xx---xE------<>-x-------------------
-E------<>-x----------------------------xxxx-------------------xx----<>---E--[]--x-----xxxx---------
<>------[]--x-----xxxx-----------------xx<>-x----QQQQQQ?-----xxx-----[]--<>--[]---x---xx---x-------x
[]------[]---x---xx<>-x---------------xx-[]--x--------------xx<>-----[]--[]--[]----x-xx-----x-----xx
-]------[]-E-Exxxx-[]-Exxxxxxxxxxxxxxxx--[]---xxxxxxxxxxxxxxx-[]--E--[]--[]--[]-----xx-------xxxxxx-
XXXXXXXXXXXXXXXXXXXXXXXXXXXXXXXXXXXXXXXXXXXXXXXXXXXXXXXXXXXXXXXXXXXXXXXXXXXXXXXXXXXXXX------XXXXXXXX