-------------------------------------------------------------------xxxxxx---------------------------
xxxxxxxxxxxxxxxxxxxxxxxxxx--------------xxxxxxxxxxxxxxxxxxxxxxxxxxxx-XXX-xxxxxxxxxxxxxxxxxxxxxxxxxxx
SSSSSSSSSSSSSSSSSSSSSSSSS-x-----SSSS---xxSSSSSSSSSSSSSSSSSSSSSSSSSSS-----SSSSSSSSSSSSSSSSSSSSSSSSSSS
---------------------------x----------xx---------------------------------SSSS-----------------------
----------------------------x----?---xx----------------------------------SSSS-----------------------
-----------------------------x--S??-xx-----------------------------------SSSS----E------------------
------------------------------x----xxX-X---------------------------------S------<>------------------
E------------------------------x--xx-------------------------------------S------[]------------E-----
S--------------------E----------xxx---------------------E------------------E----[]-----------<>-----
---E----------------<>------XXX-SSSS----------------E--<>-----------------<>---?SSS--E-------[]-----
--<>-------------XX-[]--XXX------------------E-----<>--[]----------XX-----[]--------<>-------[]--<>-
--[]------------XXX-[]--XXX-----------------<>-----[]--[]---------XXXXXX--[]--------[]---<>--[]--[]-
--[]--------E-E-XXX-[]--XXX-----------------[]---E-[]--[]--------XXXX-----[]--------[]---[]--[]--[]-
XXXXXXXXXXXXXXXXXX--XX--XX------XXXX------XXXXXXXXXXXXXXX--XXXXXXXXX-----XXXXXX----XXX---XX--XX--XX-