----------------------------------------------------------------------------------------------------
----------------------------------------------------------------------------------------------------
----------------------------------------------------------------------------------------------------
----------------------------------------------------------------------------------------------------
-------------------xxxxxxxxxxx----------E-E------------------xxxxx-------------------------xxx------
x-----------------xx--QQQ?QQQ-x-------SSSSSSS-SS-xxxx-----xxxx--X-x-----------------------xx--x-xxx-
-x---------------xx------------x-------------E--xx---x---xx--E--X--x---------------------xx-E--xx--x
X-x-------------xx------E-------x--------------xx-----x-xx---XX-X---x-------------------xx-----XX---
---x----------xxx-----SSSSSSS----x-----------xxx-------xx----XX-X----x------------xxxxxxx-----------
----x--------xx<>--------------E--x---------xx<>-------<>----XX-X-----x----------xx-XXXXX-------o---
-----x------xx-[]-------X------X---x---E---xx-[]-------[]----XX-X------x--------xx--------------o--X
------x----xx--[]-------X------X----x-----xx--[]-------[]----XX-X-------S------xx-------------------
E------xxxxx---[]----E--X------X-----xxxxxx---[]-------[]----XX-X-------xxxxxxxx--------------------
XXXXXXXXXXXXXXXXXXXXXXXXXXXXXXXXXXXXXXXXXXXXXXXX-------XX-XXXXX-XXXXXXXXXXXXXXXX--------------------