----------------------------------------------------------------------------------------------------
----------------------------------------------------------------------------------------------------
----------------------------------------------------------------------------------------------------
----------------------------------------------------------------------------------------------------
------------------------------------------------------------------------------------------E---------
-----------------------------------------------------xxxxS-------SSS-----------------SSQSSSS----S---
----------------------------------------------------xx--xxx-----------------------------------------
---------------------------------------------------xx------x-xxx------------------------------------
----------xxxx----S-------------------------------xx----E-EExx--xx-------------E--------------------
---------xx<>-x------------------E--S------------xxX--------XX-XX-x-----------<>-----SSSSSSS---xxxx-
-?QQ----xx-[]--x----------------<>---------E----xxXXX-------XX-XX--x--------------------------xx<>-x
-------xx--[]---x-----xxx-----------------<>---xxXXXX-------XX-XXX--x------------------------xx-[]--
xxxxxxxx---[]----xxxxxx--xxxxxxxxxxxxxxxxxxxxxxxXXXX--------X--XXX--Exxxxxxxxxxxxxxxxxxxxxxxxx--[]--
XXXXXXXXXXXXXXXXXXXXXXX--XXXXXXXXXXXXXXXXXXXXXXXXXXX--------X--XXXXXXXXXXXXXXXXXXXXXXXXXXXXXXXXXXXXX