----------------------------------------------------------------------------------------------------
----------------------------------------------------------------------------------------------------
--------------------------------------------------------------------E-------------------------------
----------------------------------------------------------------------------------------------------
----------------------------------------------------------------------------------------------------
---------------------------------------------SSS?SSS-------QQ?---------------oo---------------------
x----------------------------------------------------------------------------E----------------------
-x--------------------------------------------------------------------------------------------------
--x--------------------------------------------------------SSS---------------xx---------------------
?--x---------xx-------------------xxx---------SSSSSS------xxxx--------------xx-xxxxxx----ooooooooo--
-S--x-------xB-x------------------xB-x-------------------xx---x------------xx--XXXXXXx---ooooooooo--
SS---x-----xxb--x----------------xxb--x----------xxxxxxxxx-----xxxxxxxxxxxxx----------xxxxxxxxxxxxxx
oS----xxxxxx-BEE-xxxxxxxxxxxxxxxxx-BEE-xxxxxxxxxxx---x--x------XXXXXXXXXXXXX---------XXXXXXXXXXXEXXX
XX--XXXXXXXXXXXXXXXXXXXXXXXXXXXXXXXXXXXXXXXXXXXXXX-X-X--X------------------X---------X--------------