----------------------------------------------------------------------------------------------------
----X-----------------------------------------------------------------------------------------------
SSSSQS--[]SSSSSSSSSSSSS--SSS----SSSSSSSSSSSSSSSSSSSSSSSSSSSSSSSSSSSSSSS?SSSSSSSSSSSSSSSSSSSSSSSSSSSS
--------[]SSSSSSSSSS-SS---------SSSSSSSSSSSSSSSSSSSSSSSSSSSSSSSSSS------SSSSSSSSSSSSSSSSSSSSSSSSSS--
--------[]SSSSSSSSSS?SS---------SSSSSSSSSSSSSSSSSSSSSSSSSSSSSSSSSS------SSSSSSSSSSSSSSSSSSSSSSSSSS--
--------[]SSSSSSSSSSSSS---------SSSSSSSSSSSSSSSSSSSSSSSSSSSSSSSSSS------SSSSSSSSSSSSSSSSSSSSSSSSSS--
--------[]SSSSSSSSSSSSS----------------------------------------------xxxxx--------------------------
--------[]SSSSSSSSSSSSS---------x--------xxxxx-------xxxxx------xxxxxx----x----------------------xxx
xx-------]SSSSSSSSSSSSS---------xxxxxxxxxx----xxxxxxxx----xxxxxxxE--<>-----x------xxxxxxxxxxxxxxxx--
S-xxxxxx-]SSSSSSSSSSSSS---------S?SSSSSSQ?----SSSSSSS?----SSSSSSSS--[]------x--xxxx-<>?<>SSSSSSSSS--
S-SSSSSSSSSSSSSSSSSSSSS---------SS----------------------------------[]-------xxxXXX-[]-[]SSSSSSSSS--
S-SSSSSSSSSSSSSSSSSSSSS---<>----SS---------<>----------<>-----------[]-------EEXXXX-[]-[]SSSSSSSSS--
S-SSSSSSSSSSSSSSSSSSSSS---[]---------------[]----------[]-----------[]------E-XXXXX-[]<[]SSSSSSSSS--
X-XXXXXXXXXXXXXXXXXXXXXx--XXXXXXXXXXXXXXXXXXXXXXXXXXXXXXXXXXXXXXXXXXXXXX-XXXEXXXXXX-XXXXXXXXXXXXXXXX