----------------------------------------------------------------------------------------------------
----------------------------------------------------------------------------------------------------
----------------------------------------------------------------------------------------------------
----------------------------------------------------------------------------------------------------
----------------------------------------------------------------------------------------------------
----------------------------SSSS------------------------------------------------------------------SS
----------------------------------------------------------------------------------------------------
----------------------------------------------------------------------------------------------------
--------------------------xxxxxxxx----------------<>------------------------------------------------
x---------------------E--xxXXXXXX-x---------------[]---?QQQQQQQ?------------------------------------
-xxx------------------E-xx-X-------x--------------[]-----------------------------------------------x
-<>-x------------------xx--X--------x-------------[]---B-------------------?------xxxx-----xxxxx--xx
E[]-Exxxxxxxxxxxxxxxxxxx---X---------xxxxxxxxxxxxx[]---b-E-----B------E----------xx---xxxxxx----xxx-
XXXXXXXXXXXX-XXXXXXXXXXXXXXXXX-----XXXXXXXXXXXXXXXXXXXXXXXXXX-XXXXXXXXXXXXX-XXXXXXX---XXXXXX--X-XXXX