----------------------------------------------------------------------------------------------------
----------------------------------------------------------------------------------------------------
----------------------------------------------------------------------------------------------------
----------------------------------------------------------------------------------------------------
------------------------------------------------------------------E---------------------------------
----------------------------------------------------------------SSSSSS-S---SSSQ---------------?-----
----------------------------------------------------------------------E-----------------------------
---------------------------------------------------------------E------------------------------------
----------------------------------------------------------------------------------------------------
x--------------------xxx-------------------------------------S?S--------------S-----SS-----Q--Q--Q--
x--------------------xB-x-------------------Q?QQQ---------------------------------------------------
Xxxx-----xxx--------xxb--x--------------------------xxx--------------xxxxx--------------------------
XxE-xxxxxxE-xxxxxxxxx-BEE-xxxxxxxxxxxxxxxxxxxxxxxxxxx--xxxxxxxxxxxxxxx----xxxxxxxxxxxxxxxxxxxxxxxxxx
X-oXXXXXXXXXXXXXXXXXXXXXXXXXXXXXXXXXXXXXXXXXXXXXXXXXX--XXXXXXXXXXXXXXX---XXXXXXXXXXXXXXXXXXXXXXXXXXX