----------------------------------------------------------------------------------------------------
----------------------------------------------------------------------------------------------------
SSSSSSS-----SSSSSSSSSS------------------------------------------------------------------------------
-----[]---------------------------------------------------------------------------------------------
-----[]---------------xxxxxx---xxx-------------------------------->---------------------------------
o----[]------xxxxxxxxxx-----xxxx--xxxxxxxxxxxxxx---------E-------<]---------------------------------
-----[]------xSSSSSSSSS-----XXXX--SSSSSSSSSSSSX-x------------E---[]---------------------?-----------
-----[]------xSSSSSSSS------SX----------------X--x---E----------------------------------E-----------
-----[]---xxxxSSSSSSS-------------------------X---x----------------------------------------E--------
-----<>--xx--?SSSSS---------------------------X--E-x--------------------------------------<>--------
------]-xx---------------S-------------------?X-<>--x---------------------?QQ-------------[]-------<
xxx---]xx---------------------------------E---X-[]---x-----------------------------B------[]---<>--[
XX-xxxxx---------------------------------<>---X-[]----x---xxxxx-------B------------b------[]---[]--[
XXXXXXXX----XXXXXXXXXX------XXXX---------[]---X-[]-E---xxxx----xxxxxxxxxxxxxxxxxxxxxxxxxxx[]---[]--[