----------------------------------------------------------------------------------------------------
----------------------------------------------------------------------------------------------------
----------------------------------------------------------------------------------------------------
----------------------------------------------------------------------------------------------------
-------------------------------------------------------------------E--------------------------------
-----------------------------------------------------------------SSSSSSSS---SSSSSSSSS-------------SQ
-------------------------xxxx-----------------------------------------------------------------------
<>----------------------xx---x----------------------------------E-----------------------------------
[]---------------------xx-----xxx-------xxxx----S---------------------------------xxxx--------------
QQQQQ----------------xxx------<>-x-----xx<>-x-----------------S?S----------------xx--xxx-xxx-----SSQ
-----------xxxx-----xx<>------[]--x---xx-[]--x----------------------------------xx------xx--xxx-----
----------xx<>-x---xx-[]------[]---x-xx--[]---x-----xxx---------------xxxxx----xx-------<>--<>-x----
xxxxxxxxxxx-[]--xxxx--[]-E----[]----xx-E-[]----xxxxxx--xxxxxxxxxxxxxxxx----xxxxx--------[]--[]--xxxx
XXXXXXXXXXXXXXXXXXXXXXXXXXXXXXXXXXXXXXXXXXXXXXXXXXXXX--XXXXXXXXXXXXXXXX---XXXXXX------XXXXXXXXXXXXXX