----------------------------------------------------------------------------------------------------
----------------------------------------------------------------------------------------------------
----------------------------------------------------------------------------------------?-----------
----------------------------------------------------------------------------------------------------
------------------------------------------------------------------------E---------------------------
----------------------------SSSSS-----------------------------------SSSSSS---------------------xxxxx
------------------------------------------------------------------------------------------SS--xx----
---------------------------------------------------------------------------------------------xxX----
-----------------------------E---------------------------------------E----------------SS----xxXX----
----------------------------SSSSS-xxx-----------------------xxxx---SSSSSSS---xxx--------x--xxXXX----
SS--------------------xxxx-------xxX-x--B--?QQ-------------xx<>-x-----------xxX-x--B------xxXXXX----
SSx--------------B---xx<>-x-----xx-X--x-b-----------------xx-[]--x---------xx-X--x-b----xxxXXXXX----
SS-xxxxxxxxxxxxxxxxxxx-[]--xxxxxx--X---xxxxxxxxxxxxxxxxxxxx--[]---xxxxxxxxxx--X---xxxxxxx-XXXXXX---X
XXXXXXXXXXXXXXXXXXXXXXXXXXXXXXXXXXXXXXXXXXXXXXXXXXXXXXXXXXXXXXXXXXXXXXXXXXXXXXXXXXXXXXXXX-XXXXXXXXXX