----------------------------------------------------------------------------------------------------
--------------------------------------------------------xxxxxxxxxxxxxxxxxxxxxxxxxxxxxxxxxxxxxxxxxxxx
SSSSSSSSSSSSSSSSSSSSSSSSSSSSSSSSSSSSSSSSS?SSSSSSSSSSSSSSSSSSSSSSSSSSSSSSSSSSSSSSSSSSSSSSSSSSSSSSSSSS
[]---------SSS--------------------------------------------------------------------------------------
[]---------SSS--------------------------------------------------------------------------------------
[]---------SSS----------------Q-----oooooo----------------------------------------------E-----------
[]---------S--xxx----------------------------------------------------------------------<>-----------
[]---------S--xB-xx-----------------SSSSSS------------------------------E--------------[]-----------
[]---xx----S-xxb-E-x---------xxx----SSSSSS--------------------E--------<>--------------[]-------S---
[]--xx-xx---xxXXX>--x-------xxS-x-----------E----E--------SSS<>--------[]---------E--SS[]SS---E----E
<>-xx----x-xxXXXX]---xxxx--xx-S--x---------<>---<>----------S[]--------[]--<>----<>----[]----<>---<>
--xx------xxXXXXX]----<>-xxx--S---x--------[]---[]----------S[]----<>--[]--[]----[]----[]----[]---[]
xxx-------XXXXXXX]----[]--x---S----xxxxxxxx[]---[]-----------[]----[]--[]--[]----[]-E--[]----[]---[]
XXX-------XXXXXXXXXXXEXXXXX---X---XXXXXXXXX[]---[]--------XXXXXX---XX--XX--XX--XXXXXXXXXXXXXXXXXXXXX