----------------------------------------------------------------------------------------------------
----------------------------------------------------------------------------------------------------
-------------------------------------------------------------------------------------------------SSS
----------------------------------------xxx---------------------------------------------------------
------------------------------------xxxxx--x--------------------------xxxx--------------------------
----------------------------------Sxx--XX---x------------------------xx---x--------xx---------------
--------xxx------------------------x---------x-----E----------------xx-----x------xx-x--------------
E------xxXXx-------------------xxxxx----------x-xxxxx-----------xxxxx-------x----xx---xxx-----------
-----xxxXXX-x----------------xxx---x-----------xx----x--------xxx--<>--------xxxxx----<>-x---Q--Q---
----xxXXXXX--x-------SSS----xx<>---SS----------XX-----x------xx<>--[]-------SSSSS?----[]--x---------
---xxXXXXXX---x------------xx-[]-----------------------xE---xx-[]--[]-----------------[]---x--------
--xxXXXXXXX----xxx--------xx--[]------------------------x--xx--[]--[]------------S----[]----x-------
xxxXXXXXXXX----XX-xxxxxxxxx---[]-------------------------xxx---[]--[]-----------------[]-----xxxxxxx
XXXXXXXXXXXXXXXXXXXXXXXXXXXXXXXXXXXXXXXXXXXX-----------XXXXXXXXXX--XXXXXXXX--XXXXXX---XXXXXXXXXXXXXX