----------------------------------------------------------------------------------------------------
----------------------------------------------------------------------------------------------------
SSSSSSSSSSSSSSSSSSSSSSS------------------------------<----------------SSSSSSSSSSSSSSSSSSSSSSSSSSSSSS
----------------------------------------------------------------------[]----------------------------
-------------------------XXX------------------------------------------[]----------------------------
----------------------------------------XXX---------------------------<>----------------------------
-----------------------------------------------------------------xxx-----------------------------xx-
----------------------------------------------------------------xx--x--E------------------------xx-x
--------------------xxxxx-----SSSSS??--------------------------xx----xxx-----------------------xx---
------xxxx---------xxXXX-xxxx--------------------------------xxx-----<>-x-QQQQQ?QQQQ---------xxx----
xxx--xxSS-x-------xxEXXX-XXX-x-------------------------E----xx<>-----[]--x------------------xx<>----
<>-xxx-SS--x-----xxXXXXX------x------xxx---------xxx--E>---xx-[]-----[]---x----------------xx-[]----
[]--x--SS---xxxxxxXXXXXX-------xxxxxxx--xxxxxxxxxx---xxxxxxx--[]-E---[]----xxxxxxxxxxxxxxxxx--[]----
XXX-X--XX--XXXXXXXXXXXX-------XXXXXXXX--XXXXXXXXXX--xXXXXXXXXXXXXXXXXXXXXXXXXXXEEXXXXXXXXXXXXXXXXXXX