--------------------------------------------------
--------------------------------------------------
--------------------------------------------------
--------------------------------------------------
-----------E--------------------------------------
-------SSSSSS----S--------------------------------
x-------------------------------------------------
-x------------------------------------------------
--x-----------------------oo----------------------
-E-x----ESSSS---xxxx---------xxx------------------
<>--x----------xx<>-x-------xxX-x---xxxx----------
[]---x--------xx-[]--x-----xx-X--x-xx<>-x-------xx
E]----xxxxxxxxx--[]---xxxxxx--X---xx-[]--xxxxxxx--
XXXXXXXXXXXXXXXXXXXXXXXXXXXXXXXXXXXXXXX--XXXXXXX--