----------------------------------------------------------------------------------------------------
--------------------------------------------------------xx------------------------------------------
-------------------------------------------------------xx-xxx-------------------------------xxx-----
------------------------------------------------------xx--XX-x-----------------------------xx--x---x
-----------------------------------------------------xx---XX--x---------------------xxx---xx----x-xx
-----------------------------SSSSSSX----?-------xxx--xS---XX-----------------------xx--x-xx------xx-
-----------------------------------------------xx--x-x----XX----------------------xx-E--xx-------XX-
----------------------------------------------xx----xx----XX---------------------xx-----XX----------
-------SS------------------------------------xx------x----XX---x-----------xxxxxxx------------------
Qx--------------------xxx------E-----------xxx-------SS---XX----x---------xx-XXXXX-------o----------
----B----------------xxX-x------------E---xx<>------------XX-----x-------xx--------------o--XX------
x---b----xxxx------Exx-X--x--------------xx-[]------------XX------S-----xx--------------------------
-xxxxxxxxx---xxxxxxxx--X---xxxxxxxxxxxxxxx--[]E-----------XX------xxxxxxx---------------------------
XXXXXXXXXX---XXXXXXXX--XXXXXXXXXXXXXXXXXXXXXXXXXXXXXXXXXXXXXXXXXXXXXXXXXX---------------------------