----------------------------------------------------------------------------------------------------
----------------------------------------------------------------------------------------------------
----------------------------------------------------------------------------------------------------
----------------------------------------------------------------------------------------------------
--xxxxxxxxx---------------------------------------E-------------------------------------------------
--xSSSSSSS-x---------QQQQQ----------SSSS--------SSSSS-------------------------------------S---------
--x---------x--------------------------------------------------------------------------------------x
--x----------x------------------------------------------------------------------------------------xx
-xx-----E-----xxx-----------------------xxxx------E-----X---------------------------xxxx---------xx-
xxX----<>-----<>-x--E?QQQQ---------S---xx<>-x-QQQQQ?QQQQX--------------------------xx<>-x-------xx--
x-X----[]-----[]--x-------------------xx-[]--x------------------------------------xx-[]--x-----xxE--
--X----[]-----[]---x-----------------xx--[]---x---------------xxx----------------xx--[]---x---xx<>--
E-X----[]-----[]----xxxxxxxxxxxxxxxxxx---[]----xxxxxxxxxxxxxxxx-Exxxxxxxxxxxxxxxxx---[]----xxxx-[]--
XXXXXXXXX-----XX--XXXXXXXXXXXXXXXXXXXXXXXXXXXXXXXXXXXXXXXXXXXXX--XXXXXXXXXXXXXXXXXXXXXXXXXXXXXXXXXXX