----------------------------------------------------------------------------------------------------
-------------------------------------------------------------E--------------------------------------
SSSSSSSSSSSSSSSSSSSSSSSSSSSSSSSSSSSSSSSSSSSSSSSSSSSSSSSSSSSSSSSSSSSSSSSSSSSSSSSSSSSSSSSSSSSSSSSSSSSS
---SSSSSSSSSSSSS----------------------------------SSSSSSSSSSS----------------SS--SSSSS--SSSS-----SSS
E--SSSSSSSSSSSSS--------xxx-----------------------SSSSSSSSSSS----------------SS--SSSSS--SSSS--E--SSS
SSSSSSSSSSSSSSSS-xxxxxxxx--x----------------------SSSSSSSSSSS-------o------SS--------S---S----SS----
SS--------------xxSSSSSSS---xxxxxx-----------------------------------------SS--------S---S----SS----
SS-------------xx-SSSSSSS--SSSSSS-x-------------------------------S-S------SS--------S---S----SS----
xxxxxxxxxxxxxxxx--SSSSSSS--SSSSSS--xxxxxxxxxxxxxxxxxxxxxxxxxx-----SoSo-----SS----ooooS---So??-SS--E-
QQ?SSSSSSSSSSSSS--SSSSSSS--SSSSSS?SS?SSSSS????????SSSSSSSSS?-x----SSS------SSSS--SSSSS---SSS--SS-SSS
---SSSSSSSSSSSSS--------------------SSSSSSSSSSSSSS------------x--------------SS------------------E--
---SSSSSSSSSSSSS---------<>---------SSSSSSSSSSSSSS--------<>---x-------------SS---------------------
oooSSSSSSSSSSSSS---------[]-------------------------------[]----xxxxxxxxxxxxxxxxxxxxxxxxxxxxxxxxxxxx
XXXXXXXXXXXXXXXXXXXXXXXXXXXXXXXXXXXXXX-XX-XXXXXXXXXXXXXXXXXXXXXXXXXXXXXXXXXXXXXXXXXXXXXXXXXXXXXXXXXX