--------------------------------------------------
--------------------------------------------------
SSSSSSSSSSSSSSSSSSSSSSSSSSSSSSSSSSSSSSSSSSSSSSSSSS
----------------------------------SS--SSSSSS--SSSS
----------------------------------SS--SSSSSS--SSSS
--------------------oooo--------SS--------SS---S--
---------o----------------------SS--------SS---S--
-----xxxxx--------S-SSSS-S------SS--------SS---S--
-xxxxx--S-x-------SoS--SoS------SS----ooooSS---So?
xxXXXX-----xx-----SSS--SSS------SSSS--SSSSSS---SSS
xXXXXXXX--XX-xx-------------------SS--------------
XXXXXXXX--XXXX-x------------------SS--------------
XXXXXXXXE-XXXX--xxxxxxxxxxxxxxxxxxxxxxxxxxxxxxxxxx
XXXXXXXXXXXXXXXXXXXXXXXXXXXXXXXXXXXXXXXXXXXXXXXXXX