xxxx----------------------------------------------
-E--xxxxxxxxxxxxxxxxxxxxxxx-----------------------
<>SSSSSSSSSSSSSSSSSSSSSSSS-x---SSSSSSSSSSSSSSSS---
[]--------------------------x--SSSS---------------
[]---------------------------x-SSSS---------------
[]----------------------------xSSSS-------------xx
[]-----------------------------x---------------xx-
[]------------xxx---------------x-------------xx--
-]------------<>----------------oxxx------xxxxx---
-]----E-------[]---------------S?SS-x----xx-XXX---
S]---<>-------[]--<>-----E-----SSS---x--xx--------
S]---[]---<>--[]--[]----<>-----SS-----xxx---------
S]---[]---[]--[]--[]----[]-------E-EE--xX---------
XX--XXX---XX--XX--XX--XXXXXXXXXXX-XXXXXXX---------