----------------------------------------------------------------------------------------------------
----------------------------------------------------------------------------------------------------
----------------------------------------------------------------------------------------------------
-------------------xxx------------------------------------------------------------------------------
---------xxxx----xxx--x-----------------------------------------------------------------------------
--------xx---x--xxXS---x-----------------------------------------------------Q--------------S-------
-------xx-----xxxEX-----x-----------------------------------------------------------------------xxxx
------xx-------xXXX------x---------------------------------------------------------------------xx---
----xxx--------XXXXS------x------------------B------------------------------------------------xx----
---xx<>-------XXXXX--------x---------B-------b-------------------------Q---S?SQS------------xxx-----
--xx-[]------XXXXXX---------x--------b--?-B------?QQ------------------------------xxxx-----xx<>-----
Bxx--[]-----XXXXXXX----------x-------B----b------------xxxx----------------------xx<>-x---xx-[]-----
xx---[]----XXXXXXXX---------X-xxxxxxxxxxxxxxxxxxxxxxxxxx---xxxxxxxxxxxxxxxxxxxxxxx-[]--xxxx--[]-E---
XXXXXXXXXXXXXXXXXXXXXXXXXXX-XXXXXXXXXXXXXXXXXXXXXXXXXXXX---XXXXXXXXXXXXXXXXXXXXXXXXXXXXXXXXXXXXXXXXX