----------------------------------------------------------------------------------------------------
----------------------------------------------------------------------------------------------------
----------------------------------------------------------------------------------------xxxx--------
---------------------------------------------------------------------------------------xx---x-------
------------------------------------------------------------E-------------------------xx-----x----xx
--------------------------------------SSS------------------SQS--SQS------------------xx-------x--xx-
------------------------SSSSSSSSS----------------xxxx------------------------------xxx---------xxx--
------------------------------------------------xxXX-x-----------------------o-----xXX----------x---
---B----------------------------------SSS------xxXXX--x-----------------------E----xXX----------X---
---b------------Q-----------------------------xxXXXX---x---SQS--S?S--------SSSSS--xxXX---------XX---
B------?QQ----------B-----B------------------xxXXXXX----x---------------E--E-----xxXXX-------EXXX---
b-------------------b-----b--------xxxxxx---xxXXXXXX-----x---------------------Exx-XXX-------XXXX---
xxxxxxxxxxxxxxxxxxxxxxxxxxxxxxxxxxxx-----xxxxXXXXXXX-----Exxxxxxxxxxxxxxxxxxxxxxx--XXX------XXXXX---
XXXXXXXXXXXXXXXXXXXXXXXXXXXXXXXXXXXX-----XXXXXXXXXX--XXXXXXXXXXXXXXXXXXXXXXXXXXXXXXXXX---XXXXXXXXSXX