--------------------------------------------------
--------------------------------------------------
--------------------------------------------------
--------------------------------------------------
--------------------------------------------------
----------------------------------SSSSSS-----SSSSS
---------------------------------S------------[]--
--------------------------------SS------------[]--
-------------------------------SSS--------?---[]--
QQQQ---------------xxxx-------SSSS------------<>--
------------------xx<>-x--------------------------
xxx--------------xx-[]--x----xxx-----------xxx-E--
-E-xxxxxxxxxxxxxxx--[]---xxxxxB-xxxxxxxxxxxxB-xxxx
XXXXXXXXXXXXXXXXXXXXXXXXXXXXXXXXXXXXXXXXXXXXX-XXXX