----------------------------------------------------------------------------------------------------
----------------------------------------------------------------------------------------------------
----------------------------------------------------------------------------------------------------
----------------------------------------------------------------------------------------------------
----------------------------------------------------------------------------------------------------
x-------------------------------------------------------------------------------------xxx-----------
x------------------------------------------------------------------------------------xxX-x----------
------------------------------------------------------------------------------------xxXX--x---------
-------------------------xxx-----------------------------------xx------------------xxXXX---x--------
-xx--------------------xxx--x---------------------------xxxx--xx-x----------------xxXXXX----x-------
-B-x---------E--------xx<>---x----------------QQQ?-----xx---xxx---x--------------xxXXXXX-----x------
xb--x----------------xx-[]----x-------------QQ--------xx-----x-----xx-----------xxXXXXXX------x-----
xX-E-xxxxxxxxxxxxxxxxx--[]-E---xxxxxxxxxxxxxxxxxxxxxxxxX-----X-----X-xxxxxxxxxxxxXXXXXXX-------xxxxx
XXXXXXXXXXXXXXXXXXXXXXXXXXXXXXXXXXXXXXXXXXXXXXXXXXXXXXXX-----X-----XXXXXXXXXXXXXXXXXXXXXXXXXXXXXXXXX