----------------------------------------------------------------------------------------------------
----------------------------------------------------------------------------------------------------
----------------------------------------------------------------------------------------------------
----------------------------------------------------xxx---------------------------------------------
---------------------------------------------------xx]-x--------------------------------------------
SSSSSS--------------------------------------------xxX>--x-------------------------------------------
--------------------xxxxx------------------------xxXX]---x------------------------------------------
xxxx---------------xx-->-x----------------------xxXXXX----x-----------------------------------------
xS--x------------xxx---]--x--------------------xxXXXX------x------------oo----------------oo--------
-----xxx--------xx<>--QQ?--x------------------xxXXXXX<------x----------xxxx--------------xxxx-------
-----<>-x------xx-[]--------x-------xxxx-----xxXXXXXX[-------x--------xx---xxxxx--------xx---x------
]----[]--x----xx--[]---------x-----xx<>-x---xxXXXXXXX[--------x------xx----XXXX-x------xx-----x-----
]----[]---xxxxx---[]----------xxxxxx-[]--xxxxXXXXXXXX[-------X-xxxxxxx-----------xxxxxxx-------xxxxx
XXXXXXX---XXXXXXXXXXX-------XXXXXXXXXXXXXXXXXXXXXXXXXXXXXXXXXXXXXXXXXX-----------XXXXXXX------XXXXXX