----------------------------------------------------------------------------------------------------
----------------------------------------------------------------------------------------------------
----------------------------------------------------------------------------------------------------
----------------------------------------------------------------------------------------------------
----------------------------------------------------------------------------------------------------
?QQQQ----------------------xxx----------------------------------------------E-E-E-------------------
--------------------------xxX-x--------------------------------------------<><><>-------------------
-------------------------xxXX--x--------------xxxxx------------------------[][][]-----------------xx
------------------------xxXXX---x----------xxxx-<>-x-------------------Q?--QQQQQQ---------------xxx-
SSSQS------------------xxXXXX----x--------xxQQ?-[]--x------------------------------------------xx<>-
-------------xxxx-----xxXXXXX-----x------xx-----[]---x-------------------------------xxxx-----xx-[]-
------------xx<>-x---xxXXXXXX------x----xx------[]----x-----------------xxx---------xx<>-x---xx--[]-
xxxxxxxxxxxxx-[]--xxxxXXXXXXX-------xxxxx--X----[]-----xxxxxxxxxxxxxxxxxx--xxxxxxxxxx-[]--xxxx---[]-
XXXXXXXXXXXXXXXXXXXXXXXXXXXXXXXXXXXXXXXXXXXXXXXXXXXXXXXXXXXXXXXXXXXXXXXXX--XXXXXXXXXXXXXX-XXXXXX-XXX