----------------------------------------------------------------------------------------------------
--------------------------------------------------------------------------------------------------X-
SSSSSSSSSSSSSSSSSSSSSSSSSSSSSSSSSSSS[]SSSSSSSSSSSSSSSSSSSSSSSSxxx--------SSSSSSSSSSSSSSSSSSSSSSSSSSS
----------SSSSSSSSSS-------[]-------<]------------S----------xx--x----------------------------------
----------SSSSSSSSSS-------[]-------[]--E---------S---------xx----x------------------xxx------------
xx-QQ--QQQSSSSSSSSSS-------[]---QQQQQQQQQQ?-Q--------xxxxxxxx------x---------xxxxxxxxx--x-----------
S-x------------------------[]-----------------------xxSSSSSSSS------x-------xxSSSSSSSS---xxx-x------
S--x-----------------------[]--------------xxxx---Exx-SSSSSSSS-------x-----xx-SSSSSSSS--SSSSS-x-----
S---xxxxxxxxxxxxxxxxx------[]--xxxxxxxxxxxxxSSSxxxxx--SSSSSSSS--------xxxxxx--SSSSSSSS--SSSSS--xxxxx
S--QQQ????SSSSSSSSSS-x-----[]-xxSSSSSSSSSSSSSSSSSSSS--SSSSSS?S------SSSSSSSS--SSSSSSSS--SSSSS?SS?SSS
S-----SSSS------------x----<>xx-SSSSSSSSSSSSSSSSSSSS----------------SSSSSSSS--------------------SSSS
S-----SSSS-------------x----xx--SSSSSSSSSSSSSSSSSSSS----------<>----SSSSSSSS----------<>--------SSSS
S-----------------------xxxxx---SSSSSSSSSSSSSSSSSSSS----------[]---------SSS----------[]------------
X--XXXXXXXXXXXXXXXXXXXEXXXXXXE--XXXXXXXXXXXXXXXXXXXXXXXXXXXXXXXXXXXXXXXXXXXXXXXXXXXXXXXXXXXXXXXXXX-X