--------------------------------------------------
--------------------------------------------------
SSSSSSSSSSSSSSSSSSSSSSSSSSSSSSSSSSSSSSSSSSSSSSSSSS
--------------------------------SS--SSSSSS--SSSS--
--------------------------------SS--SSSSSS--SSSS--
-------------------oooo-------SS--------SS---S----
--------o---------------------SS--------SS---S----
----xxxxx--------S-SSSS-S-----SS--------SS---S----
xxxxx--S-x-------SoS--SoS-----SS----ooooSS---So??-
xXXXX-----xx-----SSS--SSS-----SSSS--SSSSSS---SSS--
XXXXXXX--XX-xx------------------SS----------------
XXXXXXX--XXXX-x-----------------SS----------------
XXXXXXXE-XXXX--xxxxxxxxxxxxxxxxxxxxxxxxxxxxxxxxxxx
XXXXXXXXXXXXXXXXXXXXXXXXXXXXXXXXXXXXXXXXXXXXXXXXXX