----------------------------------xxx---------------------------------------------------------------
----------------------xxxxxxxxxxxxx--x--------------------------------------------------------------
---------------------xxXXXXXXXXXXXX---x-------------------------------------------------------------
---------------------xXXXXXXXXXXXXX----x------------------------------------------------------------
--------------------xxXXXXXXXXXXXXX-----x-----------------------------------------------------------
----X--------------xx-XXXXXXXXXXXXX------x-----------------------------------------X----------------
------------------xxXXXXXXXXXXXXXXX-------x---------------------------------------------------------
-----------------xx-XXXXXXXXXXXXXXX--------x-------------------------------------X------------------
XX--------------xx--XXXXXXXXXXXXXXX---------x--------oo--xxxx-------------xxxx----------------------
---------------xxX--XXXXXXXXXXXXXXX----------x----------xxXX-x-----------xx<>-x---------------------
-------------xxx-X--XXXXXXXXXXXXXXX-----------x--------xxXXX--x---------xx-[]--x--------------------
x-----------xx<>-X-XXXXXXXXXXXXXXXX------------x------xxXXXX---x-------xx--[]---x----------xx-------
-xxxxxxxxxxxx-[]XX-XXXXXXXXXXXXXXXX-----------X-xxxxxxxXXXXX----xxxxxxxx---[]----xxxxxxxxxxxXxxxxxxx
XXXXXXXXXXXXXXXXXX-XXXXXXXXXXXXXXXX--XXXXXXXXXXXXXXXXXXXXXXXXXXXXXXXXXXXXXXXXXXXXXXXXXXXXXXXXXXXXXXX