--------------------------------------------------
--------------------------------------------------
--------------------------------------------------
--------------------------------------------------
--------------------------------------------------
--------------------------------------------------
--------------------------------------------------
--------------------------------------------------
xx----------------------------------xxx-----------
>-x-----------------xxxx-----------xx--x---ooooooo
]--x----QQQQQ?-----xx---xxxxx-----xx----x--ooooooo
]---x-------------xx----XXXX-x---xx------xxxxxxxxx
]----xxxxxxxxxxxxxxX----------xxxx------XXXXXXXXXX
XX-XXXXXXXXXXXXXXXXX----------XXXX------XX--------