----------------------------------------------------------------------------------------------------
----------------------------------------------------------------------------------------------------
----------------------------------------------------------------------------------------------------
----------------------------------------------------------------------------------------------------
----------------------------------------------------------------------------------------------------
XXXXXXXXXXXXXXX--------------X-----------------------------SSSSSSS---------------E------E-----------
---[]-------[]----------------------------------------------------------------E---------------------
---[]-------[]-------------X----------------------------------------------xxxxxxxxxxxxxxx-----------
---[]-------[]-------xxx------------------------------------E--E---------xxXSSSSSSSSSSSS-x----------
---[]-------[]------xx<-x----------------------------------SSSSSSS------xxXX--------------x--------Q
---<>-------<>-----xx-[]-x------------------------Q?QQQ----------------xxXXX----oooooo-----x--------
---xxx------xxx---xx--[]--x-----------xx----------------------xxx-----xxXXXX----------------xxxx----
xxxxE-xxxxxxxE-xxxx---[]---xxxxxxxxxxxxXxxxxxxxxxxxxxxxxxxxxxxx--xxxxxxXXXXX----oooooo-------x--xxxx
XXXXX-XXXXXXXX-XXXXX--XXXXXXXXXXXXXXXXXXXXXXXXXXXXXXXXXXXXXXXXX--XXXXXXXXXXXXXXXXXXXXXXX-----X--XXXX