----------------------------------------------------------------------------------------------------
----------------------------------------------------------------------------------------------------
-----------------------------------------SSSSSSSSSSSSSSSSSSSSSSSSSSSSSSSSSSSSSSSSSSSSSSSSSSSSSSSSSSS
-------------------------------------------[]---[]---------------------------------------------]----
--------------------xxxxx-xxxx-------------[]---[]-------E---------------xxx-------------------]----
x----------------xxxx----xx---x------------[]---[]---QQQQQQ--------xxxxxxx--x------------------>----
-x--------------xx-<>----<>----x-----------<>---[]----------------xxSSSSSS---xxxxx-------------]----
--x------------xx--[]----[]-----x---------------[]--------------Exx-SSSSSS--SSSSS-x------------]-E--
---x---------xxx--QQQ?---[]------x--------------[]--xxxxxxxxxxxxxx--SSSSSS--SSSSS--xxxxxxxxxxxxx<>--
--E-x-------xx<>---------[]-------x-------------[]-xxSSSSSSSSSSSSS--SSSSSS--SSSSS?SS?SSSSS??????[]--
-<>--x-----xx-[]---------[]--------x------------<>xx-SSSSSSSSSSSSS------------------SSSSS-SSSSSS[]--
>[]---x---xx--[]----]----[]---------x-----xxx----xx--SSSSSSSSSSSSS--------<>--------SSSSS-SSSSSS[]--
][]----xxxx---[]----]----[]--------X-xxxxxx--xxxxx---SSSSSSSSSSSSS--------[]---------------------]--
XXXXXXXXXXXXXXXXXXXXX----XXXXXXXXXXXXXXXXXX--XXXXXE--XXXXXXXXXXXXXXXXXXXXXXXXXXXXXXXXX-XX-XXXXXXXXXX