----------------------------------------------------------------------------------------------------
----------------------------------------------------------------------------------------------------
-----------------------------------------------------------------------------------------E----------
----------------------------------------------------------------------------------------------------
------------------------------------------xxxxxxxxxxx----------E-E----------------------------------
-----------------------------------------xx--QQQ?QQQ-x-------SSSSSSS-SS-xxxx-----xxx----------------
S-----------xxx--------------ES---------xx------------x-------------E--xx---x---xx--x---------------
S-----------xB-x------S----------------xx------E-------x--------------xx-----x-xx----x--------------
---xx------xxb-----------------------xxx-----SSSSSSS----x-----------xxx-------xx--oo--x-------------
--xx-x----xxXXX-xS------------------xx<>--------------E--x---------xx<>-------<>-------x------------
-xx---x--xxXXXX--x-----xxx---------xx-[]-------X------X---x---E---xx-[]-------[]--------x-----------
xx-----xxxXXXXX---x---xxB-x-------xx--[]-------X------X----x-----xx--[]-------[]---------xxx-------S
x-------xXXXXXX----xxxx-b--xxxxxxxx---[]----E--X------X-----xxxxxx---[]-------[]---------XX-xxxxxxxx
X-------XXXXXXXXXXXXXXXXXXXXXXXXXXXXXXXXXXXXXXXXXXXXXXXXXXXXXXXXXXXXXXX-------XX-XXXXXXXXXXXXXXXXXXX