----------------------------------------------[-----------------------------------------------------
----------------------------------------------------------------------------------------------------
--------------------------------------------XXXX------------------------SSSSSSSSSSSSSSSS------------
--------------------xxx----------------------[]---------xxxxx-------------[]SSSSSSSSSSSS------------
---------xxxx----xxxx--x---------------------[]-------xxx----x------------[]SSSSSSSSSSSS------------
-SSSSSS-xx---x--xxXXS---x--------------------<>------xx<>-----x-----------[]SSSSSSSSSSSS------------
-------xx-----xxxEXX-----x--------------------------xxX[]------x----------<>SSSSSSSSSSSS--[---------
------xx-------xXXXX------x-------------------x-----xXX[]-------x-----------SSSSSSSSSSSS--[---------
--xxxxx--------XXXXSS------x-----------------xx---xxxXX[]--------x----------SSSSSSSSSSSS------------
-xx<><>-------XXXXX---------x---------------xx-x-xx<>XX[]---------x---------SSSSSSSSSSSS--------E---
-x-[][]------XXXXXX----------x-------------xx---xxX[]XX[]----------x--------SSSSSSSSSSSS---E---<>---
E--[][]S----XXXXXXX-----------x------xxxxxxx---<>XX[]XX[]-----------x----xxxSSSSSSSSSSXS--<>---[]--X
x--[][]----XXXXXXXX----------X-xxxxxxx--XXXX---[]XX[]XX[]--------x-X-xxxxx--SSSSSSSSSSQS--[]---[]-XX
XXXXXXXXXXXXXXXXXXXXXXXXXXXX-XXXXXXXXX---------[]XXXXXXXXXXXXXXXXXXXXXXXXX--XXXXXXXXXXXX--XX---XXXXX