--------------------------------------------------
----------------------------------xxx-------------
---------------------------------xx--x------------
--------------------------------xx----x-----------
-------------------------------xx------x----------
----------------S------------xxx--------x---------
----------------------------xx-S---------x--------
---------------------------xx-------------x-------
---------------xxxx-------xx---------------xxx----
--xxx---------xx<>-x-----xx-----E----------<>-x---
ExxX-x-------xx-[]--x---xxE----<>----------[]--x--
xx-X--x-----xx--[]---x-xx<>----[]----------[]---x-
x--X---xxxxxx---[]----xx-[]----[]----------[]-E-Ex
XXXXXXXXXXXXXXXXXXXXXXXXXXXXXXXXXXXXXXXXXXXXXXXXXX