----------------------------------------------------------------------------------------------------
----------------------------------------------------------------------------------------------------
----------------------------------------------------------------------------------------------------
----------------------------------------------------------------------------------------------------
-----xxxxxxxxxxx-------------------xxxxxxxxxx-------------------------------------------E-----------
----xx--QQQ?QQQ-x-----------------xx--QQQ?QQ-x-------SSSS?--------------------------SSSSSS----------
---xx------------x---------------xx-----------x-----------------------------------------------------
--xx------E-------x-------------xx------EE-----x----------------------------------------------------
xxx-----SSSSSSS----x----------xxx-----SSSSSS----x-----------------------E----------X-E--------------
x<>------------X----x--------xx<>---------X---E--x----EXXX--SSS---E----<>----------XSSSSSS------xxxx
-[]-------X-XXXX-----x------xx-[]-------XXX---X---x--------------<>----------------------------xx---
-[]-------X-XXXX------x----xx--[]-------XXX---X----x--------------------------xxxxx-----------xx----
-[]----E--X-XXXX-------xxxxx---[]----E--XXX---X-----xxxxxxxxxxxxxxxxxxxxxxxxxxx----xxxxxxxxxxxx-----
XXXXXXXXXXXXXXXXXXXXXXXXXXXXXXXXXXXXXXXXXXXXXXXXXXXXXXXXXXXXXXXXXXXXXXXXXXXXXXX---XXXXXXXXXXXXX-----