----------------------------------------------------------------------------------------------------
----------------------------------------------------------------------------------------------------
------------------------------------------------------------------------oo-------------------------X
-------------------------o--------------------------------------------------------------------------
----------------------------------------xxxxx-------------------------------------------------------
-----------------------SSS-----------xxxx--X-x--------------------------XXX---XXX-------------------
------------------------------------xx--E--X--x-----------------------------------------------------
X-------------------xxxxxxxxx------xx---XX-X---x------------------------------xxxx------------------
Q?----------------xxx---x----xx--xxx----XX-X----x-------------------------xxxxx---x---------xxxx----
------ESSS-------xx<>---S---<>-xxx<>----XX-X-----x---------------XXXX----xxXXXX----x-------xx<>-x---
----------------xx-[]-------[]--x-[]----XX-X------x---------------------xx----------x-----xx-[]--x--
-xxx-----------xx--[]-------[]----[]----XX-X-------x-------xxx---xxx---xx--------E---x---xx--[]---x-
xx--xxxxxxxxxxxx---[]----E--[]----[]----XX-X-------Xxxxxxxxx--xxxx--xxxx--------<>----xxxx---[]----x
XX--XXXXXXXXXXXXXXXXXXXXXXXXXXXXXXXXXXXXXX-XXXXXXXXXXXXXXXXX--XXXX--XXXX--------[]----XXXXXXXXXXXXXX