----------------------------------------------------------------------------------------------------
----------------------------------------------------------------------------------------------------
------------------------------XXXX------------------------------------------------------------------
-------------------------------[]---------xxx----------------------------o--------------------------
-------------------------------[]-------xxx--x----------------------------------------------------xx
-------------------------------<>------xx<>---x------------------------SSS-------E----------------xx
--------------------------------------xxX[]----x--------------------------------<>----------------x-
--------------------------------E-----xXX[]-----x-------------------xxxxxxxxx---[]-------------xxxx-
------------------------------------xxxXX[]------x----------------xxx---x----xx-XXX----------xxx--S-
---------------xxxx-----------xxxx-xx<>XX[]-------x-------SSS----xx<>---S---<>-x------------xx<>----
xx------------xx---xx--------xx---xxX[]XX[]--------x------------xx-[]-------[]--x-xxxxxx---xx-[]----
>-x--xxxxx---xx---<>-x------xx---<>XX[]XX[]---------xxx--------xx--[]-------[]---xx<><>-x-xx--[]----
]--xxxE---x-xx----[]--xxxxxxx----[]XX[]XX[]--------XXX-xxxxxxxxx---[]----E--[]----x[][]--xx---[]----
XXXXX<>----xx-----XXXXXXXXXXX----[]XXXXXXXXXXXXXXXXXXXXXXXXXXXXXXXXXXXXXXXXXXXXXXXXXXXXXXXXXXXXXXXXX