----------------------------------------------------------------------------------------------------
----------------------------------------------------------------------------------------------------
----------------------------------------------------------------------------------------------------
----------------------------------------------------------------------------------------------------
----E-----------------------------------------------------------------------------------------------
SSSSSSSSSS--------------------------------Q-Q-------------------------------------------------------
----------------------------------------------------------------------------------------------------
----------------------------------------------------------------------------------------------------
----------------X----------------------------------------------------------------------------oo-----
--xxx---SSSSSSSSX-------------------------Q-Q-----------------------------------------------xxxx----
xxxX-x-------------------------------------------------------------------------xxx---------xx---x---
-x-X--x------------------------------------------------xxxx------xxxxx-xxx----xxX-x-------xx-----x--
x--X---xxxxxxxxxxxxxxxxxxxxxxxxxxxxxxxxxxxxxxxxxxxxxxxxx---xxxxxxx----xx--xxxxx-X--xxxxxxxx-------xx
XXXXXXXXXXXXXXXXXXXXXXXXXXXXXXXXXXXXXXXXXXXXXXXXXXXXXXXX---XXXXXXX---XXX--XXXXXXXXXXXXXXXXX------XXX