--------------------------------------------------
-----------------xxx------------------------------
----------------xx--x-----------------------------
---------------xx----xx---------------------------
--------------xx-----E-xxxxxx---------------------
------------xxx---------x----x-------SSSSSSS------
-----------xx-S--------<>-----x-------------------
----------xx-----------[]------xxxx--------xxx----
---------xx------------[]-------xB-xxxxxxxxx--x---
S-S-----xx-------X-----XX-------XXXXESSSSSSS---x--
xxx----xxE---------------------XXXXXX-----------x-
<>-x--xx<>--------------------XXXXXXX------------x
-]--xxx-[]-----X-------------XXXXXXXX-----------B-
XXXXXXXXXXXXXXXX-------------XXXXXXXXXXXXXXXXEXXXX