]---------------------------------------------------------------------------------------------------
--------------------------------------------------------------xx------------------------------xxxx--
S-SSSSSS[]SSSSSSSSSSSSSSSSSSSSSSSSSSSSSSSSSSSSSSSSSSSSSSSSSSSSS-x---SSSSSSSSSSSSSSSS---------xx--xx-
--------[]-------------------------SSSSSSSSSSSSSSSSSSSSSSSS------x--SSSS--------------------xx-----x
--------[]---xxx-------------------SSSSSSSSSSSSSSSSSSSSSSSS-------x-SSSS-------------------xx-------
--xxxxxxxxxxxx--xxx----------------SSSSSSSSSSSSSSSSSSSSSSSS--------xSSSS-------------xx--xx<>-------
-xxSSSSSSSSSSS-<>--xxxx---------------------------------<>----------x---------------xx-xxx-[]-------
xx-SSSSSSSSS-S-[]--SSS-x-----------------------xxxxx----[]-----------x-------------xx--XXX-[]-------
x--SSSSSSSSS<S-[]--SSS--xxxxxxxxxxxxxxxxxxxxxxxx----xxxx[]-----------oxxx------xxxxx--------]-------
S--SSSSSSSSS[S-[]--SSS?SS?SSSS?????SSSSSSSSSSSS?----SSSSX]----------S?SS-x----xx-XXX--------]-------
S--------------[]--------SSSSSSSSSS----------------------]----E-----SSS---x--xx-----------SSS-------
S-------------<]]--------SSSSSSSSSS--------------<>------]---<>-----SS-----xxx------------SSS-------
S>------------[]]--------------------------------[]------]---[]-------E-EE--xX------------SSS-------
X]XXXXXXXXXXXXXXXXXXXXXXXXX-X-XXXXXXXXXXXXXXXXXXXXXXXXXXXXXXXXXXXXXXXX-XXXXXXX---------XXXSSS-X-XXXX