----------------------------------------------------------------------------------------------------
----------------------------------------------------------------------------------------------------
----------------------------------------------------------------------------------------------------
----------------------------------------------------------------------------------------------------
----------------------------------------------------------------------xxxxxx------------------------
------------------------------------E-E-E----------------------------xx?SSS-x-----------------------
-----------------------------------<><><>----------------------------x-------x----------------------
----xxxxx--------------------------[][][]-----------------------xxxxxx--------x---------------------
-xxxx-<>-x---------------------Q?--QQQQQQ------xxxx------------xx---xE------<E-x--------------------
xxQQ?-[]--x--------------------------------Q--xx<>-x----------xx----<>------[>--x-------------------
x-----[]---x---------------------------------xx-[]--x-------xxx-----[]--<>--[]---x------------------
------[]----x-------------------xxx---------xx--[]---x-----xx<>-----[]--[]--[]----x----xxxxx-xxx---x
-X----[]-----xxxxxxxxxxxxxxxxxxxx--xxxxxxxxxx---[]----xxxxxx-[]--E--[]--[]--[]-----xxxxx----xx--xxxx
XXXXXXXXXXXXXXXXXXXXXXXXXXXXXXXXX--XXXXXXXXXXX-XXXX---XXXXXXXXXXXXXXXXXXXXXXXXXXXXXXXXXX---XXX--XXXX