----------------------------------------------------------------------------------------------------
----------------------------------------------------------------------------------------------------
----------------------------------------------------------------------------------------------------
----------------------------------------------------------------------------------------------------
----------------------------------------------------------------------------------------------------
-------------------------------------xxx------------------XXXX--------------------------------------
------------------------------------xxX-x-----------------------------------------------------------
-----------------------------------xxXX--x----------------------------------------------------------
----------------------------------xxXXX---x---------------------------------------------------------
-----------xxx-------------------xxXXXX----x-------------------------------------xxx----------------
xxxx------xxX-x-----------------xxXXXXX-----x-----xxx---------------------------xxX-x---------------
x---x----xx-X--x---------------xxXXXXXX------x---xxB-x------------xxxx-xxx-----xx-X--x-------------x
X----xxxxx--X---xxxxxxxxxxxxxxxxXXXXXXX----X--xxxx-b--xxxxxxxxxxxxx---xx--xxxxxx--X---xxxxxxxxxxxxxx
XX--XXXXXXX-X--XXXXXXXXXXXXXXXXXXXXXXXXXXXXXXXXXXXXXXXXXXXXXXXXXXXX---XX--XXXXXXXXX--XXXXXXXXXXXXXXX