-------------------------------------------------x--------------------------------------------------
--------------------------------------------------x-------------------------------------------------
---------------------------------------------------x------------------------------------------------
----------------------------------------------------x-----------------------------------------------
-----------------------------------------------------x----------------------------------------------
SSSS--------------------------------------------------x---------------------------------------------
----xxxxxxxxxx-------------------------?---------------x----xxxxxxxxxx------------------------------
---xxXXXXXXXX-x------------------------E----------------x--xxXXXXXXXX-x------x----------------------
--xxXXXXXXXX---x----xx--------------------E--------------xxxXXXXXXXX---x----xx-----------xx---------
-xxXXXX---------x--xx-x-xxx--------------<>---------------xXXXX---------x--xx-x-xxxxx---xx-x-xxxxx--
xxXXXXX----------xxx---xx--x-------------[]---------------XXXXX----------xxx---xx----x-xx---xx----x-
xXXXXXX-----------x----<>---x----B-------[]---<>---------XXXXXX-----------x----<>-----xx----<>-----x
XXXXXX----<>-----<>----[]----x---b-------[]---[]---------XXXXX----<>-----<>----[]-----<>----[]-----<
XXXXXX----[]-----[]----[]-----xxxxxxxxxxx[]---[]---------XXXXX----[]-----[]----[]-----[]----[]-----[