----------------------------------------------------------------------------------------------------
----------------------------------------------------------------------------------------------------
SSSSSSSSSSSSSSSSSSSSSSSS----------------------------------------------------------------------------
----------------------------------------------------------------------------------------------------
--------------------------XXX-------------------------xxx-------------------------------------------
-----------------------------------------------------xxXXx------------------------------------------
----------------------------------------------------xx----x------xxxx-------------------------------
---------------------------------------------------xx------x----xxXX-x------------------------------
---------------------xxxxx-------xx-----------xxxxxx--------x--xxXXX--x----------xx-----------xxxxxx
xxx------xxxx-------xxXXX-xxxx--xx-x-xxxxx---xx-XXEXXX-------xxxXXXX---x-xxxxx--xx-x-xxxxx---xx-XXXX
x--xxx--xxSS-x----xxxEXXX-XXX-xxx---xx----x-xx----------------xXXXXX----xx----x-x---xx----x-xx------
<>-<>-xxx-SS--x----xXXXXX------x----<>-----xx----------------XXXXXXX----<>-----x>---<>-----xx-------
[]-[]--x--SS---xxxxXXXXXX-----<>----[]-----<>---------------XXXXXXXX-<>-[]-----<]---[]-----<>-------
XXXXXXXX--XX--XXXXXXXXXX------[]----[]-----[]---------------XXXXXXX--[]-[]-----[]---[]-----[]-------