-------------S--------------------------------------------------------------------------------------
-------------S--------------------------------------------------------------------------------------
----[]SSSSSSSSSSSSS--------------------------------------------------------------------------------X
----[]SSSSSSSSSSSSS---------------------------------------------------------------------------------
----[]SSSSSSSSSSSSS--------------------------------------------------------------xxxxx--------------
----[]SSSSSSSSSSSSS-------------------xxxxx----------E--------------------------xxXX--x-------------
----[]SSSSSSSSSSSSS------S-----------xx-<>-x--------<>-------------------------xxXXX---x------------
----[]SSSSSSSSSSSSS-----------------xx--[]--x-------[]-------------------------xXXXX----x-----------
-----]SSSSSSSSSSSSS---------------xxx---[]---x------[]--xxx-------------------xxXXXX-----x----------
xxxx-]SSSSSSSSSSSSS--------------xx<>--QQQ?---x-----[]-xx--x--------------xxxxxXXXXX------x--------x
ESSSSSSSSSSSSSSSSSS---E---------xx-[]----------x----->xx----xx-----------xxE--XXXXXX-------x------xx
>SSSSSSSSSSSSSSSSSS--<>--------xx--[]-----------x----xx----<>-x----B----xx<>-XXXXXXX--------x----xx-
]SSSSSSSSSSSSSSSSSS--[]---xxxxxx---[]------E-----xxxxx--E--[]--xxxxxxxxxx-[]-XXXXXXX-------<-xxxxx--
XXXXXXXXXXXXXXXXXXXx-XX---xXXXXXXXXXXX-----X---XXXXXXXXXXXXXXXXXXXXXXXXXXXXXXXXXXXXXXXXXXXXXXXXXXX--