----------------------------------------------------------------------------------------------------
--------------------------------------------------------------x-------------------------------------
---XXXX------------------------------------------------------<>-------------------------------------
x---[]-------------------------------------------------------[]---------------------------------xxx-
----[]--------------xxx------xxx-----------------------------[]----------------------------xxxxxx--x
----<>------xxx----xx--x----xxX-x---------------------E------[]-------------------------E-xxXXXXX---
-----------xx--x--xx----x--xxEX--x-------------------<>------[]--------------------------xxXXXX-----
-----E----xx----xxx------xxxXXX---x------------------[]-----xxxx------------------------xxXXXXX-----
---------xx------x--------xXXXX----x-----------------[]---xxx-------------------------xxxXXXXXX-----
---xxxx-xx-------S-------XXXXXX-----x----------------XXX-xx<>---x--------xxx---------xx<>XXXXXX-----
--xx---xxX--------------XXXXXXX------x------------------xx-[]----x------xSS-x-------xx-[]XXXXXX-----
-xx---<>XX-------------XXXXXXXX-------xx-------xxx---xxxx--[]-----x----xxSS--x-----xx-X[]XXXXXX-----
xx----[]XX------------XXXXXXXXX-------X-xxxxxxxx--xxxx-x---[]------xxxxx-SS---xxxxxx-XX[]XXXXXX-----
XX----[]XX----XXXXXXXXXXXXXXXXXXXXXXXXXXXXXXXXXX--XXXX-X--XXXXXXXXXXXXXXXXXXXXXXXXXXXXXXXXXXXXXXXXXX