----------------------------------------------------------------------------------------------------
----------------------------------------------------------------------------------------------------
----------------------------------------------------------------------------------------------------
----------------------------------------------------------------------------------------------------
----xxx---------------------------------------------------------------------------------------------
SS-xx--x--------xx---------E--------E-S---SSSSSSSSSS------------SS---SS-------------S---------------
--xx----x------xx-x-------<>-------<>---------------------------------------------------------------
xxx-----<x----xx---xxx----[]-------[]---------------------------------------------------------------
Ex------[-xxxxx----<>-x---[]-------[]------------xxxx---------SS--------------xxx-------------xxxxx-
SS------X-XSSS?----[]--xxx--------SXX-----------xx--xxx-xxx---------SSS---xxxxx--xSSS-----xxxxx-XX-x
---------E---------[]--<>-x-xxxx-----xxxx------xx------xx--xxx-----------xxXX<>---x------xxXX<>-XX--
-----<>-->----S----[]--[]--xx<>-x---xx<>-x----xx-------<>--<>-x-xxxxx---xxXXX[]----x----xxXXX[]-XXX-
-----[]--]---------[]--[]---x[]--xxxx-[]--xxxxx--------[]--[]--xx----xxxxXXXX[]-SS--xxxxxXXXX[]-XXX-
XXXXXXXXXXXXXXXX---XXXXXXXXXXXXXXXXXXXXXX--XXXX------XXXXXXXXXXXX-X-XXXXXXXX-X]--XXXXXXXXXXX-XXXXXXX