----------------------------------------------------------------------------------------------------
----------------------------------------------------------------------------------------------------
------------------------------------------SSSSSSSSSSSSSSSSSSSSSSS-----------------------------------
----------------------------------------------------------------------------------------------------
-------------------------xxxxx-------------------------------------XXX------------------------------
------------------------xxXX--x----------------------------------------------------------XXX--------
-----------------------xxXXX---x--------------------------------------------------------------------
----------------------xxXXXX----x-------------------------------------------------------------------
x--------------------xxXXXXX-----x----------------------------xxxxx-----SSSS-XX?--------------------
-xx---SSQS--------xxxxXXXXXX------x-----------QQQQ-----------xxXXX-xxxx--------------------------xx-
<>-x------------xxx--XXXXXXX-------x-----------------------xxxEXXX-XXX-x------------------------xx-x
b]--x----------xx<>-XXXXXXXX--------xx-------------xxxx---xxXXXXXX------x------------xxx-------xx---
B]---xxxxxxxxxxx-[]XXXXXXXXX--------X-xxxxxxxxxxxxxx---xxxxXXXXXXX-------xxxxxxxxxxxxx--xxxxxxxx----
XXXXXXXXXXXXXXXXXXXXXXXXXXXXXXXXXXXXXXXXXXXXXXXXXXXX--XXXXXXXXXXX-------XXXXXXXXXXXXXX--XXXXXXXX----