----------------------------------------------------------------------------------------------------
---------------------xxx----------------------------------------------------------------------------
--------------------xx-x----------------------------------------------------------------------------
-------------------xx---x---------xxx----------------------------------------------------o----------
----------xxxxx---xx-----x------xxx--x------------------------------xxxxxxxxxxxx--------------------
------xxxxx----x--xS------x----xxXS---x----------------------------xx--QQQ?QQQQ-x-------SSS---------
-----xx-<>------x-x--------x--xxEX-----x--------------------------xx-------------x------------------
----xx--[]-------xx---------xxxXXX------x---------------X--------xx------E--------x----------------x
--xxx---[]--------x----------xXXXXS------x---------------------xxx-----SSSSSSSS----x-------------xxx
-xx<>--QQQ?-------SS--------XXXXXX--------x---------B---------xx<>---------------E--x-----------xx<>
xx-[]----------------------XXXXXXX---------x--------b--?-----xx-[]-------X-------X---x---E-----xx-[]
x--[]---------------------XXXXXXXX----------x-------B-------xx--[]-------X-------X----x-------xx--[]
---[]------E---x---------XXXXXXXXX---------X-xxxxxxxxxxxxxxxx---[]----E--X---E---X-----xxxxxxxx---[]
XXXXXX-----X---XXXXXXXXXXXXXXXXXXXXXXXXXXX-XXXXXXXXXXXXXXXXXXXXXXXXXXXXXXXXXXXXXXXXXXXXXXXXXXXXXXXXX