------------------------------------------------------------------------------------------x--xxx----
-------------------------------------------------------------------------xx-------xxx-------xx--x---
-----------------------------------------------SSS----------------------xx-x-----xx--x-----xx----x--
-----------------------------------------------[]----------------------xx---x---xx----x---xx------x-
-----------------------------------------------[]--------------------x-x-----x-xx------xxxx--------x
xxx------------------XX------------------------[]--------------------x-S------xx-------XXXX--------X
<>-x-----------------[]------------------------<>--------------------xx-------XX--------------------
[]--x----------------[]----------------------------------------------xB------------------------oo---
[]---x----xxxx-------[]-------------------------------xxxx----------xxb------------------------SS---
[-----x--xx---xx-----<>SSSSSS-------------------------x<>-x--------xxXXX----------------------------
>------xxx----X-x--------------------------------------[]--x------xx-XXX----------------------------
]-------x-----XX-xx---Exxx--------Q-------------E------[]---x----xx--XXX----------------------------
]-------B-----XXXX-xxxxxE-xxxxxxxxxxxxxxxxxxxxxxxxxxxxx[]-E--xxxxx-E-XXX--------------o-------------
XXXXXXXXX-----XXXXXXXXX<>XXXXXXXXXXXXXXXXXXXXXXXXXXXXXXXXXXXXXXXXXXXXXXXXXXX----------X-------------