--------------------xx-------------------------------------------------------x----------------------
----------------------x-------------------------------------------------------x---------------------
-----------------------x-------------------------------------------------------x-----xxxx-----------
------------------------x-------------------------------------------------------x---xx---xx---------
-------------------------x-----------xxxxx---------------------------------------x-xx----E-xxxxx----
--------------------------xxxxxxxxxxxx----xxxxxxxxxxxxxx--------E-----------------xx--------x---x---
--------------------------SSSSSSSSSSSS----SSSSSSSSSSSSX-x-----------E-------------XX-------XX----x--
------------------------------------------------------X--x----------------------------------------x-
------------------------------------------------------X---x----------------------------------------x
---xxx---------------------------E--------------------X--E-x----------------------------------------
--xxX-x-------------------------<>------S------------?X-<>--x---------------------------------------
Exx-X--x------------------------[]----------------E---X-[]---x-------------------------------------X
xx--X---xxxxxxxxxxxxx-----------[]---------------<>---X-[]----x--xxxxx---<--B---------------------XX
XX--XXXXXXXXXXXXXXXXX-----------[]---------------[]---XS[]-E---xxx----xxxxxxxx--------------------XX