----------------------------------------------------------------------------------------------------
----------------------------------------------------------------------------------------------------
----------------------------------------------------------------------------------------------------
----------------------------------------------------------------------------------------------------
------------------------------------------------------------------------xxxxxx----------------------
-x------------SSSSSSS--------SSSSS------SSSS---------------------------xx?SSS-x---------------------
---o-ooo---------------------------------------------------------------x-------x--------------------
----o-------------x-----------------------------------------------xxxxxx-------Ex-------------------
--xxxx----------xxx--xxxx-------------------------xxxx-----------xx---xE------<>-x------------------
--x<>-x-------xxxSS-xx<>-x-QQQQ--QQQ-------------xx<>-x---------xx----<>---E--[]--x-----------------
-x-[]--x-----xx<>--xx-[]--x---------------------xx-[]--x------xxx-----[]--<>--[]---x----------------
xx-[]---x---xx-[]--x--[]---x-----------xxxxx---xx--[]---x----xx<>-----[]--[]--[]----x-xxxxx--------E
x--[]----xxxx--[]-----[]----xxxxxxxxxxxx----xxxxE--[]----xxxxx-[]--E--[]--[]--[]-----xx----xxxxxxxxx
XXXXXXXXXXXXXXXXXXXXXXXXXXXXXXXXXXXXXXXX----XXXXXXXXXX---XXXXXXXXXXXXXXXXXXXXXXXXXXXXXX---XXXXXXXXXX