----------------------------------------------------------------------------------------------------
----------------------------------------------------------------------------------------------------
------------------------------------------------------------E---------------------------------------
----------------------------------------------------------------------------------------------------
-------------------------------------E--------------------------------------------------------------
-----------------------x-----E-SSSSS-------------------------XX---------------------------------xxxx
-----X--------------------E--------------------------------------------------------------------xxXXX
---X-X----------------xxxx--------------------------------------------------------------------xx----
-E-X-X-----------xxxxxx---x---------------------------X---X--------------------xxx-----------xx-----
->XX-X----------xxXXXXX----x----SSS----------------X--------------------------xx--x----------x------
-]XX-X--------xxx-----------x--------------<>------X-------------------------xx----x--------XX------
-XXX-X-------xxXXX-----------x-------------[]------X------------------x-----xx------x---------------
xxxxxxxxxxxxxx----------------xxxxxxxxxxxxx[]------X--------X----------xxxxxx--------xxxxx----------
XXXXXXXXXXXXXXXXXX------------XXXXXXXXXXXXXXXXXXXXXX----XXXXX---------XXXXXXX--------XXXX-----------