------------------------------------------------------------------------------------x---------------
-------------------------------------------------------xx----------------------------x--------------
------------------------------------------------------xx-xxx--------------------------x---SSSSSSSSSS
-----------------------------------------------------xx--XX-x--------------------------x--SSSS------
----------------------------------------------------xx---XX--x--------------------------x-SSSS------
-------------------------------SSSSS---?-------xxx--xS---XX---x--------------------------xSSSS------
----------------------------------------------xx--x-x----XX----x--------------------------x---------
-E-------------------------------------------xx----xx----XX-----x--------------------------x--------
<>------------------------------------------xx------x----XX------x-------------Q--?--------oxxx-----
--------------------xxx-----S---E---------xxx-------SS---XX-------x---------Q-E-----------S?SS-x----
-------------------xxX-x-------------E---xx<>------------XX--------x----------E-----------S-----x--x
-----xxxxx-------Exx-X--x---------------xx-[]------------XX---------x----------------X----S------xxx
xxxxxx----xxxxxxxxx--X---xxxxxxxxxxxxxxxx--[]E-----------XX--------X-xxxxxxxxxxxxxxxxX------E-EE--xX
XXXXXX---XXXXXXXXXX--XXXXXXXXXXXXXXXXXXXXXXXXXXXXXXXXXXXXXXXXXXXXXXXXXXXXXXXXXXXXXXXXXXXXXXX-XXXXXXX