----------------------------------------------------------------------------------------------------
---------xx-----------------------------------------------------------------------------------------
SSS-----xx-x-----------------------------SSSSSSSSSSSSSSSS-E<]SSSSSSSSSSSSSSSSSSSSSS---SSSSSS--------
-------xx---x------------------------------[]----[]------<>[]---------------------------------------
-----x-x-----x-------------xxxx------------[]----[]------[][]------------xxx------xxxx--------------
----xxxSS-----x-----------xxXX-x-----------[]----[]---QQQQQQQ------xxxxxxx--x-----x---x-------xx--xx
---xx----------x---------xxXXX--x----------<>----[]---------------xxSSSSSS---xxxxxx----x-----xx-xxx-
--xx------------x-------xxXXXX---x---------------[]--------------xx-SSSSSS--SSSSSSS-----x---xx--XXX-
xxx----x---------x-----xxXXXXX----x--------------[]--xxxxxxxxxxxxx--SSSSSS--SSSSS--------xxxx-------
oSS----SS---------x---xxXXXXXX-----x-------------[]-xxSSSSSSSSSSSS--SSSSSS--SSSS---------XXX--------
S-S----SS----------x-xxXXXXXXX------x------------<>xx-SSSSSSSSSSSS---------------------------------S
S-S----SS-----------xxXXXXXXXX-------x----xxx-----Xx--SSSSSSSSSSSS--------<>-----------------------S
S-S----------------XXXXXXXXXXX--------xxxxx--xxxxxxx--SSSSSSSSSSSS--------[]-----------------------S
XxXXXXXXXX---------XXXXXXXXXXXXXXXXXXXXXXXX--XXXXXXX--XXXXXXXXXXXXXXXXXXXXXXXXXXXXX-------------XXXS