-------xxxxx--------------------------------------
xxxxxxxx----xxxxxxxxxxxxxxxxxxxxxxxxxxxxxxxxx-----
SSSSSSSS----SSSSSSSSSSSSSSSSSSSSSSSSSSSSSSSS-x---S
SSSS--------SSSS------------------------------x--S
SSSS--------SSSS-------------------------------x-S
SSSS--------SSSS----E---------------------------xS
-------------------<>----------------------------x
-------------------[]------------E----------------
E-------------E----[]-----------<>----------------
><>----------<>---?SSS--E-------[]---------------S
][]----------[]--------<>-------[]--<>-----E-----S
][]----------[]--------[]---<>--[]--[]----<>-----S
][]----------[]--------[]---[]--[]--[]----[]------
XXXXXX--XXXXXXXXXX----XXX---XX--XX--XX--XXXXXXXXXX