-----------------------XXXX-XXXXXXXXX---XXXXXXXXXXXXXXXXXXXXX----[]XXXXXXXXXXXXXXXXXXXXXX-XXXXX--X-Y
----------------------------------------------------------------------------------------------------
----------------------------------------------------------------------------------------------------
---------------------------------------------------------------XXXX---------------------------------
-----------xxxx----xxxx-----------------------------------------[]---------xxxxx--------------------
-S--------xx---x--xxXQ-x----------------------------------------[]-------xxx----x-------------------
---------xx-----xxxEX---x---------------------------------------<>------xx<>-----x------------------
--------xx-------xXXX----x---------------------------------------------xxX[]------x-----------------
---xxxxxx--------XXXXSSS--x--------------------------------------E-----xXX[]-------x-----------xxxxx
-xxx---<>-------XXXXX------x-----------------------------------------xxxXX[]--------x--xxx---xxx--x-
xx<>---[]------XXXXXX-------x----------------------------------xxxx-xx<>XX[]---------xxxS-x-xxXX--X-
x-[]---[]-----XXXXXXX--------x-------------------xxx----------xx---xxX[]XX[]----------x--Q-xxXXX--X-
--[]---[]----XXXXXXXX---------x------xxxxx------xxX-x--------xx---<>XX[]XX[]----------SS-SSxXXXX--X-
X-XX--XXXXX-XXXXXXXXXXXX-----X-xxxxxxx----xxxxxxx-X--xxxxxxxxx----[]XX[]XX[]--------X-SS-SSXXXXX--X-