----------------------------------------------------------------------------------------------------
----------------------------------------------------------------------------------------------------
----------------------------------------------------------------------------------------------------
--------------------------xxxxx--------------------------------------------------o------------------
------------------------xxx----x--------------------------------------------------------------------
-------E--S------------xx<>-----x---------------------------------------------SSSS-------E----------
------<>--------------xxX[]------x------------------------------------------------------<>----------
------[]-------------xxXX[]-------x-----------xxxxxx-----oooo---------------xxxxxxxxx---[]----------
------[]-----------xxxXXX[]--------x--xxx---xxx--x--x----oooo-------------xxx---x----xx-XXX---------
x----SXXS---------xx<>XXX[]---------xxxS-x-xxXX--X---x-------------------xx<>---S---<>-x------------
-xx------xxxx----xx-[]XXX[]----------x----xxXXX--X----xxxxxxxxxxxxx-----xx-[]-------[]--x-xxxxxx---x
<>-x----xx<>-xx-xx-X[]XXX[]----------SS-SSxXXXX--X----XXXXXXXXXXXX-x---xx--[]-------[]---xx<><>-x-xx
[]--xxxxx-[]---xx-XX[]XXX[]--------X-SS-SSXXXXX--X----X-------------xxxx---[]----E--[]----x[][]--xx-
XXXXXXXXXXXXX-XXXXXXXXXXXXXXXXXXXXXXXXXXX-XXXXX--X----X-------------XXXXXXXXXXXXXXXXXXX-XXXXXXXXXXXX