----------------------------------------------------------------------------------------------------
--------------------------xxx-----------------------------------------------------------------------
-------------------------xx--x-----xxxx-----xx------------------------------------------------------
------------------------xx----x---xx---x-?-xx-x-------xxx----xxxx-----------------------------------
-----------------xxx---xx------x-xx-----x-xx---x-xxxxxx--xxxxx---x----------------------------------
----------------xx--x-xx--------xx-------xx-----xx---XX--XXXXX-S--x---------------------------------
---------------xx-E--xx---------XX-------XX-----XX-----------------x--------------------------------
--------------xx-----XX---------------------------------------------x-------------------------------
--------xxxxxxx------------------------------------------------------x------------------------------
-------xx-XXXXX-------o---------------------------------------E-S-----xxx----------------E--S-------
x-----xx--------------o--XX----------------------------------<>-------<>-x--------------<>----------
-x---xx------------------------------------------------------[]-------[]--x-Exxx------------------B-
B-xxxx-------------------------------------------------------[]-------[]---xxx--xxxxxxxxxxxxxxxxxxxx
XXXXXX---------------------------------------------------XXXXXXXXXXXXXXXXXXXXX--XXXXXXXXXXXXXXXXXXXX