----------------------------------------------------------------------------------------------------
----------------------------------------------------------------------------------------------------
----------------------------------------------------------------------------------------------------
----------------------------------------------------------------------------------------------------
----------------------------------------------------------------------------------------------------
----------------------------------------------------------------X-----------------------------------
----xxxx--------------------------------------------------------------------------------------------
---xx---x----------------------------------------------------X--------------------------------------
--xx-----x---------------------------S----------------xxxx-----------------------------o----------xx
xxx-------x---------------------------------xxx------xx<>-x--------------------------------------xx<
x<>--------x---------------xxxx-----xxx----xxX-x----xx-[]--x------------------------------------xx-[
-[]---------x-------------xx<>-x---xxS-x--xx-X--x--xx--[]---x--------xxxxxxxxx-xxx-------------xx--[
-[]---------Xxxxxxxxxxxxxxx-[]--xxxx-S--xxx--X---xxx---[]----xxxxxxxxx---x----xx--xxxxxxxxxxxxxx---[
XXX--------XXXXXXXXXXXXXXXXXXXXXX<>XXXXXXXXXXXXXXXXXXXXXXXXXXXXXXXXXXX-X-X-XX-XX-XXXXXXXXXXXXXXXXXXX