----------------------------------------------------------------------------------------------------
----------------------------------------------------------------------------------------------------
----------------------------------------------------------------------------------------------------
----------------------------------------------------------------------------------------------------
----------------------------------------------------------------------------------------------------
----------------------------------------------------------------------------------------------------
--xxxx----------------------------------------------------------------------------------------------
-xx---x----------------------E-----------------------------xx---------------------------------------
xx-----xxx-------xxxxx----S---------------------------xx--xx-x---------------------------------xxxx-
x------<>-x-----xx<>X-x------------------------xxxx--xx-xxx---xxx-------------------------E---xx<>-x
>------[]--x---xx-[]---x---------------E------xx---xxx---x----<>-x-----?QQ----------------E--xx-[]--
]------[]---x-xx--[]----x------xxx--x--------xx-----x----X----[]--x-------------------------xx--[]--
]-E----[]----xx-E-[]-----xxxxxxxX-xx-xxxxxxxxxX-----X----XX---[]---xxxxxxxxxxxxxxxxxxxxxxxxxxX--[]--
XXXXXXXXXXXXXXXXXXXXXXXXXXXXXXXXXXXXXXXXXXXXXXX-----X----XXX--[]XXXXXXXXXXXXXXXXXXXXXXXXXXXXXXXXXXXX