--------------------------------------------------
xxxxxxxxxxxx--------------------------------------
SSSSSSSSSSS-x---SSSSSSSSSSSSSSSS-------------SSS--
-------------x--SSSS------------------------------
--------------x-SSSS------------------------------
---------------xSSSS-------------xx--xxxxx--------
----------------x---------------xx-xxx----x-------
-----------------x-------------xx--XXX-----x------
E----------------oxxx------xxxxx------------x-----
>---------------S?SS-x----xx-XXX-------------xxxxx
]---------E-----SSS---x--xx-----------SSS-S--SSSSS
]--------<>-----SS-----xxx------------SSS-S--SSSSS
--------x[]-------E-EE--xX------------SSS-S--SSSSS
X--XXXXXXXXXXXXXXX-XXXXXXX---------XXXSSS-S--XXXXX