----------------------------------------------------------------------------------------------------
----------------------------------------------------------------------------------------------------
--------------------------------------------------------------------SSSSSSSSSSSSSS---------XXXX-----
-----------xxxxxx-------------------------------------X-------------------------------------[]------
-----xxxxxxx-----x--------------------------------xxxxx-------------------------------------[]------
----xx--QQQ?------x----------------------------E-xxXXX-x------------------------------------<>------
---xx----------<---x-----xxxxx------------------xxXXXX--x-----------------<-->------E--------------x
--xx------E----[----x---xx----x----------------xxXXXXX---x-------------------------<>--------------x
xxx-----SSSS---E-----x-xx------xxx-----------xxxXXXXXX----x------------------------[]------------xxx
x<>-----------<>------xx-------<>-x---------xx<>XXXXXX-----x----------------------XXXX-----xxxx-xx<>
-[]-------X---[]------<>-------[]--x-------xx-[]XXXXXX------x--------------------XX-------xx---xxX[]
-[]-------X---[]------[]-------[]---x-----xx-X[]XXXXXX-------xxx--------xxx-xxx-XXXxxx---xx---<>XX[]
-[]----E--X---[]------[]-E-----[]----xxxxxx-XX[]XXXXXX-------XX-xxxxxxxxx--xx--xxxxx--xxxx----[]XX[]
XXXXXXXXXXXXXXXXXXXXXXXXXXXXXXXXXXXXXXXXXXXXXXXXXXXXXXXXXXXXXXXXXXXXXXXXX--XX--XXXXX--XXXX----[]XXXX