xx--------------------------------------------------------------------------------------------------
x---------------------------------------------------------------------------------------------------
--x------SSS----------------------------------------------------------------------------------------
---x------------------------------------------------------------------------------------------------
----x-----------------------------xxxxxxxxxx----------EE--------------------------------------------
-----x---------------------------xx--QQQ?QQ-x-------SSSSSS-SSSSSS-----------------xxxxx-----------xx
------x-------------------------xx-----------x------------E----------------------xx-<>-x----------x<
-------x-----------------------xx------E------x---------------------------------xx--[]--x---------x[
--------x-----xxx------------xxx-----SSSSSS----x----------xxxxxxxx------------xxx---[]---x-------xx[
---------xxxxxx--x----------xx<>-------------E--x--------xx<x--<>-x----------xx<>--QQQ?---x------xS[
-E-------SSSSXS---x--------xx-[]-------X----<>---x---E--xx-[]--[]--x--------xx-[]----------x-------[
<>-------SSSSXS----x------xx--[]-------X----[]----x----xx--[]--[]---x------xx--[]-----------x------[
[]------------------xxxxxxx---[]----E--X----[]-----xxxxx---[]--[]----xxxxxxx---[]------E-----xxxxx-[
XXXXXXXXXXXX-XX----XXXXXXXXXXXXXXXXXXXXXXXXXXXXXXXXXXXXXXXXXX--XX--XXXXXXXXXXXXXXX-----X---XXXXXXXXX