xxx--xxxxxx-----------------------------------------------------------------------------------------
---xxx----xxxxxxxxxxxxxxxxxxxxxxxxxxxxxxx-----------------------------------------------------------
----x-------SSSSSSSSSSSSSSSSSSSSSSSSSSSSS-----------------------------------------------------------
XXXXX--------------------------------[]-------------------------------------------------------------
X------------------------------------[]-------------------------------------------------------------
X------------------------------------[]----------------------------------------------------------xxx
X--------X---------------------------[]----------X--EX------------------------------------------xx-<
X------------------------------------<>----------X---X-----------------------------------------xx--[
X------------------------E-----------------X---X-X---X--------X-EE----X-----------------E----xxx---[
X-----------------------<>-----E-----------XSSSX-XSS?X--------XSSSSSSSX---------------------xx<>--QQ
X-----------------------[]----<>----S-S-S-------------------------------------------oo-----xx-[]----
X-----------ooooooooo---[]----[]----S-S-S-----------------xxx-----------------------oo----xx--[]----
B-----------ooooooooo---[]----[]----S-S-Sxxxxxxxxxxxxxxxxxx--xxxxxxxxxxxxxxxxxxxxxxxxxxxxxx---[]----
X---X-------XXXXXXXXX---[]----[]----S-S-SXXXXXXXXXXXXXXXXXX--XXXXXXXXXXXXEEXEXXXXXXXXXXXXXXXXXXX----