---X------------------------------------------------------------------------------------------------
---------------------------------------------------------------------------------------X------------
SSSSSSSSSSSSSSSSSSSSSSSSSSSSSSSSSSS?SSSSSSSSSSSSSSSSSSSSSSSSSSSSS----------SSSSSSSSSSSSSSSSSSSSSSSS-
----------SS--SS------SSSS-------------------------------------------------------------------------x
----------SS--SS--E---SSSS-----------------------------------------XXX----------------------------xx
--------SS--------SS--SSSS----oooooo-----------------------------------------ooo------------------xS
--------SS--------SS--S-----------------------------------------------------o---------------------x-
X-------SS--------SS----------SSSSSS-------------------------------------------S-----------------xx-
X-------SS----o??-SS---E------SSSS-S--------------------------xxxxx-----SXSSSSSSo---------------xxS-
X----x--SSSS--SS--SS--SSSS---------------------xxxx----------xxXXX-xxxx-------------------x-----x---
X---------SS---------EE-----------------------xxSS-x--------xxEXXX-XXX-x-----------------------xx---
X---------SS-------------xxxxx--------------Exx-SS--x------xxXXXXX------x---------------------xx---E
xxxx-xxxxxxxxxxxxxxxxxxxxx----xxxxxxxxxxxxxxxx--SS---xxxxxxxXXXXXX-------xxxxxxxxxxxxxxxxxxxxxx-----
XXXXxXXXXXXXXXXXXXXXXXXXXX---XXXXXXXXXXXXXXXXX--XX--XXXXXXXXXXXXX-------XXXXXXXXXXXEXEXXXXXXXXXXXXXX