----------------------------------------------------------------------------------------------------
----------------------------------------------------------------------------------------------------
--------------------------------------------------------------------XXXX----------------------------
---------------------------------------------------------------------[]---------xxxxx---------------
-----xxxxxxxxxxx----------E-E------------------xxxxx-----------------[]-------xxx----x--------------
----xx--QQQ?QQQ-x-------SSSSSSS-SS-xxxx-----xxxx--X-x----------------<>------xx<>-----x-------------
---xx------------x-------------E--xx---x---xx--E--X--x----------------------xxX[]------x------------
--xx------E-------x--------------xx-----x-xx---XX-X---x---------------------xXX[]-------x----------x
xxx-----SSSSSSS----x-----------xxx-------xx----XX-X----x-------------xx---xxxXX[]--------x--xxx--xxx
x<>--------------E--x---------xx<>-------<>----XX-X-----x-----------xx-x-xx<>XX[]---------xxxS-xxxXX
-[]-------X-X----X---x---E---xx-[]-------[]----XX-X------x---------xx---xxX[]XX[]----------x----xXXX
-[]-------X-X----X----x-----xx--[]-------[]----XX-X-------x-------xx---<>XX[]XX[]----------SS-SSXXXX
-[]----E--X-X----X-----xxxxxx---[]-------[]----XX-X-------Xxxxxxxxx----[]XX[]XX[]--------X-SS-SSXXXX
XXXXXXXXXXXXXXXXXXXXXXXXXXXXXXXXXX-------XX-XXXXX-XXXXXXXXXXXXXXXXX----[]XXXXXXXXXXXXXXXXXXXXXX-XXXX