----------------------------------------------------------------------------------------------------
----------------------------------------------------------------------------------------------------
----------------------------------------------------------------------------------------------------
----------------------------------------------------------------------------------------------------
-------------------------------xxxxx-----------------------E-----------------------------------xxxxx
------------------------------xxXXX-x------------------SQS----------------------------------E-xxXXX-
-----------------------------xx-XXX--x---------------------------------x---------------------xxXXXX-
----------------------------xx--XXX---x----------------------------------xxxxxx-------------xxXXXXX-
--------xxxx----S----------xx---XXX----x-------------------------------xxx-----x----------xxxXXXXXX-
-------xx<>-x-------------xxX--XXXX-----x--------Ex---SSQS------------xx<>------xx-------xx<>XXXXXX-
------xx-[]--x-----------xxXXX-XXXX------x------<>-x-----------------xx-[]-----<>-x-----xx-[]XXXXXX-
x----xx--[]---x----xxxx-xxXXXX-XXXX-------xxx---[]--x---------------xx--[]-----[]--x---xx-X[]XXXXXX-
-xxxxx---[]----xxxxx---xxXXXXX-XXXX-------XX-xxx[]---xxxxxxxxxxxxxxxx---[]--E--[]---xxxx-XX[]XXXXXX-
XXXXXXXXXXXXXXXXXXXX--XXXXXXX--XXXXXXXXXXXXXXXXXXXXXXXXXXXXXXXXXXXXXXXXXXXXXXXXXXXXXXXXXXXXXXXXXXXXX