----------------------------------------------------------------------------------------------------
----------------------------------------------------------------------------------------------------
----------------------------------------------------------------------------------------------------
----------------------------------------------------------------------------------------------------
----------------------------------------------------------------------------------------------------
-------------SSS?SSSS---------------------------------------------------------------------------xx--
-----------------------------------------------------------------------------------------------xx-x-
----------------------------------------------------------xx----------------------------------xx---x
--------------------------------------oo-----------------xx-x---------oooo----------------xxxxx-----
Q------------SSSSSSSS----------------o--o-----------xxxxxx---xxx----------------E--------xx--XX-----
---------------------------------------------------xx---x----<>-x-------------------E---xx---XXX----
x---xxx----------xxx------xxxx--------------------xx----X----[]--x---------------------xx----XXXX---
-xxxxE-xxxxxxxxxxx--xxxxxxx---xxxxxxxxxxxxxxxxxxxxxX----XX---[]---xxxxxxxxxxxxxxxxxxxxxxX----XXXXX--
XXXXXXXXXXXXXXXXXX--XXXXXXX---XXXXXXXXXXXXXEEXEXXXXX----XXX--[]XXXXXXXXXXXXXXXXXXXXXXXXXX----XXXXXX-