----------------------------------------------------------------------------------------------------
----------------------------------------------------------------------------------------------------
XE----------SS-----------------XXXXX----------------------------------------------------------------
]-----------[]-------------------[]-----------------------------------------------------------------
]-----------[]-------------------[]-------------------------------------------xxxxxxx---------------
]-----------<>-------------------[]------------------------------------------xx-SSSS-x--------------
]--------------------------------[]-----------------------------------------xx--------x-------------
]------------E-------------------[]----------------------------------------xx----------x------------
]---------xxxx-------------------[]------xxxx-----------------------------xxX-----------x--------xxx
]--------xx<>-x-QQQQQ?QQQQQQ?Q---<>-----xxX--x--------------x------S?S---xxEX---S-----X--x------xx<>
--------xx-[]--x-----------------------xx-X---x------------x-x----------xxXXX---------X---x----xx-[]
xx-----xx--[]---x---------------------xx--X----x----------xx--x--------xxXXXX---------XX---x--xx--[]
x-xxxxxx---[]----xxxxxxxxxxxxxxxxxxxxxx--EX-----xxxxxxxxxxxX---xxxxxxxxxXXXXX----EE---XX---Exxx---[]
X-XXXXXXXXXXXXXXXXXXXEEXXXXBXEXXXXXXXXXXXXX-----XXEXXXXXXXXX---XXXXXXXXXXXXXXXXXXXXXXXXXXXXXXXXXXXXX