----------------------------------------------------------------------------------------------------
----------------------------------------------------------------------------------------------------
----------------------------------------------------------------oo----------SSSSSSSSSSSSSSSS--------
----------------------------------------------------------------------------SSSS--------------------
--------------------------------xxxxx------------------------------------xx-SSSS--------------------
-----------------------------E-xxXXX-x--------------------------XXX-----xx-xSSSS-------------xx--xxx
------------------------------xxXXXX--x--------------------------------xx---x---------------xx-xxx--
--xxxxx----xxxxx-------------xxXXXXX---x------------------------------xx-----x-------------xx--XXX--
xxx----x-xxx----x----------xxxXXXXXX----x-------------------------xxxxx------oxxx------xxxxx--------
x<>-----xx<>-----xx-------xx<>XXXXXX-----x-----------------XXXX--xxXXXX--X--S?SS-x----xx-XXX--------
-[]----E<>[]----<>-x-----xx-[]XXXXXX------x---------------------xx----------SSS---x--xx-----------SS
-[]---<>[][]----[]--x---xx-X[]XXXXXX-------xxx-------xxx---xxx-xx-----------SS-----xxx------------SS
-[]---[][][]----[]---xxxx-XX[]XXXXXX-------XX-xxxxxxxx--xxxx--xx--------------E-EE--xX------------SS
XXXXXXXXXXXXXXXXXXXXXXXXXXXXXXXXXXXXXXXXXXXXXXXXXXXXXX--XXXX--XX--------XXXXXX-XXXXXXX---------XXXSS