----------------------------------------------------------------------------------------------------
----------------------------------------------------------------------------------------------------
---------------------------------------------------------xxxx--?--xxx--------xxxx--?----------------
--------------------------------------------------------xx---x---xx--x------xx---x---xxx-------xx---
E------------------------------------------------------xx-----xxxx----x----xx-----xxxx--x-----xx-x--
SSxxx-----------------------------E-------------------xx------XXXX-----x--xx------XXXX--ox---xx---x-
-xx--x---------------------------<>-----------------xxx-----------------xxx-------------o-xxxx-----x
xx----x--------------------------[]-----------o-----xXX-----------------XXX---------------XXXX------
x------x-------------------------[]------------E----xXX---------------------------------------------
S-------xxx-----------xxx-----S--[]SS-------SSSSS--xxXX---------------------------------------------
--------<>-x---------xxX-x---------------E--E-----xxXXX---------------------------------------------
--------[]--x------Exx-X--x---------------------Exx-XXX-----------XXX-----------------XXX-----------
--------[]---xxxxxxxx--X---xxxxxxxxxxxxxxxxxxxxxxx--XXX---------------------------------------------
XXXXXXXXXXXXXXXXXXXXX--XXXXXXXXXXXXXXXXXXXXXXXXXXXXXXXX---XEX----------------XXEX---------------XXXX