----------------------------------------------------------------------------------------------------
----------------------------------------------------------------------------------------------------
----------------------------------------------------------------------------------------------------
----------------------------------------------------------------------------------------------------
---------------------------------------------------------------------------------------------------x
E--------------------------------------------SSSSSSS-----------------------------------------xxxxxxx
>---------------------------------------------------------------E---------------------------xx?QQQQQ
]-----------------------------------------------------------xxxxx--------------------------xx-------
]---------------------------------------------E--E---------xxXSSS-------------------------xx--------
>-----X-X------------------------------------SSSSSSS------xxXX---x------------------xxxxxxx---------
-----XX-----------------------------Q?QQQ?---------------xxXXX----x----QQQQQ?Q-----xx--QQQ?---S-----
XXXXXXX-------------xxx-------------------------xxx-----xxXXXX-----x--------------xx----------------
xxxxxxxxxxxxxxxxxxxxxE-xxxxxxxxxxxxxxxxxxxxxxxxxx--xxxxxxXXXXX------xxxxxxxxxxxxxxxX----------------
XXXXXXXXXXXXXXXXXXXXXXXXXXXXXXXXXXXXXXXXXXXXXXXXX--XXXXXXXXXXXXXXXXXXXXXXXXXXXXXXXXX-----------EE---