----------------------------------------------------------------------------------------------------
----------------------------------------------------------------------------------------------------
----------------------------------------------------------------------------------------------------
----------------------------------------------------------------------------------------------------
----------------------xxxxxxxxxx----------E-E------------------xxxxx--------------------------------
---------------------xx--QQQ?QQ-x-------SSSSSSS-SS-xxxx-----xxxx--X-x-------------------------------
--------------------xx-----------x-------------E--xx---x---xx--E--X--x------------------------------
-xxxxx-------------xx------E------x--------------xx-----x-xx---XX-X---x--------------xxxxx----------
xx--S-x------o---xxx-----SSSSSSS---x-----------xxx-------xx----XX-X----x----------xxxx-<>-x---Q--Q--
x------xx-------xx<>-------------E--x---------xx<>-------<>----XX-X-----x--------xxQQ?-[]--x--------
------<>-x-----xx-[]-------X-----X---x---E---xx-[]-------[]----XX-X------x------xx-----[]---x-------
------[]--x---xx--[]-------X-----X----x-----xx--[]-------[]----XX-X-------x----xx------[]----x------
>-E---[]---xxxx---[]----E--X-----X-----xxxxxx---[]-------[]----XX-X--------xxxxx--X----[]-----xxxxxx
XXXXXXXXXXXXXXXXXXXXXXXXXXXXXXXXXXXXXXXXXXXXXXXXXX-------XX-XXXXX-XXXXXXXXXXXXXXXXXXXXXXXXXXXXXXXXXX