----------------------------------------------------------------------------------------------------
----------------------------------------------------------------------------------------------------
----------------------------------------------------------------------------------------------------
----------------------------------------------------------------------------------------------------
--------------------------xxxxxx--------------------------------------------------------------------
----SSSSSSSSSS-----------xx?SSS-x--------------------------------SSSSS---?-------xxx-------SSSSSSS-x
-------------------------x-------x----------------------------------------------xx--x-------------xx
--------------------xxxxxx-------Ex--------------------------------------------xx----xxxx--------xx-
-----------xxxx----xx---xE------<>-x------------------------------------------xx------xB-xxxxxxxxx--
xxx-------xx--xxx-xx----<>---E--[]--x-----------------xxx-----S---E---------xxx-------XXXXESSSSSSS--
<>-x-----xx------xx-----[]--<>--[]---x---------------xxX-x-------------E---xx<>-------XXXXX---------
[]--x---xx-------<>-----[]--[]--[]----x-xxxxx------Exx-X--x---------------xx-[]------XXXXXX---------
[]---xxxx--------[]--E--[]--[]--[]-----xx----xxxxxxxx--X---xxxxxxxxxxxxxxxx--[]-E---XXXXXXX---------
XXXXXXXXX------XXXXXXXXXXXXXXXXXXXXXXXXXX---XXXXXXXXX--XXXXXXXXXXXXXXXXXXXXXXXXXXXXXXXXXXXXXXXXXXXX-