----------------------------------------------------------------------------------------------------
----------------------------------------------------------------------------------------------------
SSSSSSSSSSSSSSSSSSSSSSSSSSSSSSSSSSSSSSSSSSSSSSSSSS?SSSSSSSSSSSSSSSSSSSSSSSSSSSSSSSSSSSSSSSSSSSSSSSS-
---------------SS--SSSSSS--SSSS------SSSS-----------------------------------------------------------
---------------SS--SSSSSS--SSSS--E---SSSS-----------------------------------------------------------
-------------SS--------SS---S----SS----------oooooo-------------------------------------------------
-------------SS-------oSS---S----SS--------------------------------xx-------------------------------
-------------SS--------SS---S----SS----------SSSSSS---------------xx-x-xxx--------------------------
-------------SS----ooooSS---So??-SS---E------SSSSSS--------------xx---xx--x---------------------xxxx
QQQQ---------SSSS--SSSSSS---SSS--SS--SSSS----------------------xxx----<>---x------xxxx---------xxXXX
-------B-------SS-------------------EE------------------------xx<>----[]----xxx--xxSS-x-------xxEXXX
E------b-------SS-----------------------xxxxx----------------xx-[]----[]----<>-xxx-SS--x-----xxXXXXX
xxxxxxxxxxxxxxxxxxxxxxxxxxxxxxxxxxxxxxxxx----xxxxxxxxxxxxxxxxx--[]----[]--E-[]--x--SS---xxxxxxXXXXXX
XXXXXXXXXXXXXXXXXXXXXXXXXXXXXXXXXXXXXXXXX---XXXXXXXXXXXXXXXXXXXXXXXXXXXXXXXXXXXXX--XX--XXXXXXXXXXXX-