xxxx------------------------------------------------------------------------------------------------
x---xxxxxxxx----------------------------------------------------------------------------------------
S-SSSSSSSSSSSSSSSS----------------------------------------------------------------------------------
----------------------------------------------------------------------------------------o-----------
----------------------xxxx---------------------------xxxxxxxxxxx------------------------------------
---------------------xxX--x-------------------------xx--QQQ?QQQ-x-------SSSS----------SSS-------E---
--------------------xx-----x-----------------------xx------------x-----------------------------<>---
------------x------xx-------x---------------------xx------E-------x----------------xxxxxxxxx---[]---
--------E----x----xx---------x------------------xxx-----SSSSSSS----x-------------xxx---x----xx-XXX--
-------<>-----x--xxXXX--------x----------------xx<>--------------E--x----SSS----xx<>---S---<>-x-----
-------[]------xxxX------------x--------------xx-[]-------X------X---x---------xx-[]-------[]--x-xxx
<>-----[]-------xXX-------------x------------xx--[]-------X------X----x-------xx--[]-------[]---xx<>
[]-----[]------XXXX-------------Xxxxxxxxxxxxxx---[]----E--X------X-----xxxxxxxx---[]----E--[]----x[]
XX-----[]------XX------XXXXE---XXXXXXXXXXXXXXXXXXXXXXXXXXXXXXXXXXXXXXXXXXXXXXXXXXXXXXXXXXXXXXXXXXXXX