--------------------------------------------------
--------------------------------------------------
--------------------------------------------------
--------------------------------------------------
--------------------------------------------------
----------------------------------------SSSSS-----
--------------------------------------------------
--------------------------------------------------
----------------xxxxx--------------------E--------
xx------------xxx----x------------------SSSSS-xxx-
>-x----------xx<>-----xx---------xxxx--------xxX-x
]--x------B-xx-[]----<>-x---B---xx<>-x------xx-X--
]S--xxxxxxxxx--[]-E--[]--xxxxxxxx-[]--xxxxxxx--X--
XXXXXXXXXXXXXXXXXXXXXXXXXXXXXXXXXXXXXXXXXXXXXXXXXX