--------------------------------------------------
xxxxxx--------------------------------------------
SSSSSS--------------------------------------------
--------------------------------------------------
--------------------------------------------------
E-------------------------------------------------
>-------------------------------------------------
]-------------------------------------------------
]-------------------------------------------------
]------------------------------xxx----------------
]---SS------------------------xxX-x---------------
]---SS---------------------B-xx-X--x--------------
]---SSxxxxxxxxxxxxxxxxxxxxxxxx--X---xxxxxxxxxxxxxx
XX--XXXXXXXXXXXXXXXXXXXXXXXXXXXXXXXXXXXXXXXXXXXXXX