--------------------------------------------------
--------------------------------------------------
--------------------------------------------------
--------------------------xxx---------------------
----------------xxxx----xxx--x--------------------
---------------xx---x--xxXS---x-------------------
--------------xx-----xxxEX-----x------------------
----xxxxx----xx-------xXXX------x-----------------
--xxx----x-xxx--------XXXXS------x----------------
-xx<>-----xx<>-------XXXXX--------x---------B-----
xx-[]----E<>[]------XXXXXX---------x--------b---?-
x--[]---<>[][]-----XXXXXXX----------x-------B-----
---[]---[][][]----XXXXXXXX---------X-xxxxxxxxxxxxx
XXXXXXXXXXXXXXXXXXXXXXXXXXXXXXXXXX-XXXXXXXXXXXXXXX