----------------------------------------------------------------------------------------------------
----------------------------------------------------------------------------------------------------
[-]SSSSSSS------------------------------------------------------------------------------------------
]--SSSSSSS------------------------------------------------------------------------------------------
]--SSSSSSS-----------------------------xxx----------xxxxx-------------------------------------------
]--SSSSSSS----------S--------------xxxxx--xxxxxxxxxxx----xxxxxxxxxxxxxx---------E-------------------
]SSSSSSSSS----------S-------------xxXXXX--SSSSSSSSSSS----SSSSSSSSSSSSX-x------------E---------------
]SSSSSSSSS----------S------------xx----------------------------------X--x---E-----------------------
]SSSSSSSSS----------S--------xxxxx-----------------------------------X---x--------------------------
]SSSSSS-------------S-------xx-XXX--------------E--------------------X--E-x-------------------------
SSSSSSS<>-----------S------xx------------------<>------S------------?X-<>--x-----------------?QQ----
SSSSSSS[]---<>------S-----xx-------------------[]----------------E---X-[]---x-----------------------
SSSSSSS[]---[]------Sxxxxxx--------------------[]---------------<>---X-[]----x---xxxxx---B----------
XXXXXXXXXXXXXXXXXXXXXxXXXXX--------------------[]---------------[]---X-[]-E---xxxx----xxxxxxxxxxxxxx