----------------------------------------------------------------------------------------------------
----------------------------------------------------------------------------------------------------
--X------------------------SS----------------Q]-XXXX------------------------------------------------
---------------------------[]--------------------[]------------------------------------------S------
---------------------------[]--------------------[]------------------------------------------S------
--------------E------------<>--------------------[]------------------------------------------SSSSS--
-------------------------------------------------[]------------xxxx-------------------------S-------
----------------------------E--------------------[]-----------xx---xxx---------------------SS-------
-------------------------xxxx--------------------[]----------xx-----x-x-------------------SSS-------
B----E--S---------------xx<>-x-QQQQQQ?QQQQQQQ?Q--<>-----xxxxxx------S--xS----------------SSSSx------
b---->-------------E---xx-[]--x------------------------xxE--x-----------x---------------------------
xx--------------------xx--[]---x----------------------xx<>-XX------------x------xxx-----xxx---------
X-xxxxxxxxxxxxxxxxxxxxx---[]----xxxxxxxxxxxxxxxxxxxxxxx-[]-XX-------------xxxxxxxE-xxxxxxB-xxxxxxxxx
XXXXXXXXXXXXXXXXXXXXXXXXXXXXXXXXXXXXXEEXXXXXEXEXXXXXXXXXXXXXX-------------XXXXXX<>XXXXXXXXXXXXXXXXXX