----------------------------------------------------------------------------------------------------
----------------------------------------------------------------------------------------------------
----------------------------------------------------------------------------------------------------
---------------------------------------------------------------o----------------------------------xx
-----xx-------------------------xxxx----------------------------------------------------xxxx----xxx-
----xx-x---SSooSSSSS-----------xxXX-x------------------------SSS-------E---------------xx---x--xxXS-
---xx---x---------------------xxXXX--x--------------------------------<>--------------xx-----xxxEX--
--xx-----x-xxxx----xxxx------xxXXXX---x-------------------xxxxxxxxx---[]-------------xx-------xXXX--
-xx-------xx---xxxxx---x----xxXXXXX----x----------------xxx---x----xx-XXX----------xxx-------XXXXXS-
xxX-----XXXS---SSSSS----x--xxXXXXXX-----x-------SSS----xx<>---S---<>-x------------xx<>------XXXXXX--
xXX----------------------xxxXXXXXXX------x------------xx-[]-------[]--x-xxxxxx---xx-[]------XXXXXX--
XXX-----------------------xXXXXXXXX-------xxx--------xx--[]-------[]---xx<><>-x-xx--[]-----XXXXXXX--
XXX---X------------------XXXXXXXXXX-------XX-xxxxxxxxx---[]----E--[]----x[][]--xx---[]----XXXXXXXX--
XXX---XXXXXXXXXXXXXXXEXXXXXXXXXXXXXXXXXXXXXXXXXXXXXXXXXXXXXXXXXXXXXXXXXXXXXXXXXXXXXXXXXXXXXXXXXXXXXX