--------------------------------------------------
--------------------------------------------------
--------------------------------------------------
--------------------------------------------------
--------------------------------------------------
-------------------------QXX----------------------
E----------------------------------------XXXSSSSSS
--------------------------------------------------
--------------------------------------------------
QQ------------------xxxx-?---------------------SSS
-------------------xx<>-x-------------------------
---------xxx------xx-[]--x------xxx---------------
xxxxxxxxxx--xxxxxxx--[]---xxxxxxx--xxxxxxxxxxxxxxx
XXXXXXXXXX--XXXXXXXXXXXXXXXXXXXXX--XXXXXXXXXXXXXXX