----------------------------------------------------------------------------------------------------
----------------------------------------------------------------------------------------------------
----------------------------------------------------------------------------------------------------
----------------------------------------------------------------------------------------------------
-------------------------------xxxxxx---------------------------------------------------------------
--------SSSS------------------xx?SSS-x--------------------------------------------------------------
------------------------------x-------x------------------SSSSSSSSSSSSSSSS---------xxx--------------E
-------------------------xxxxxx-------Ex------------------------------------------xB-x------S-------
------------xxxx--------xx---xE------<>-x-----------------------------xxxx-------xxb----------------
xx---------xx<>-x------xx----<>---E--[]--x-----xxxx-----------SSSSSS-xx--xxx----xxXXX-xS------------
B-x-------xx-[]--x---xxx-----[]--<>--[]---x---xx---x----------------xx----S-x--xxXXXX--x-----xxx----
b--x-----xx--[]---x-xx<>-----[]--[]--[]----x-xx--------------------xx-----S--xxxXXXXX---x---xxB-x---
?---xxxxxx---[]----xx-[]--E--[]--[]--[]-----xx-----Xxxxxxxxxxxxxxxxx------S---xXXXXXX----xxxx-b--xxx
XXXXXXXXXXXXXXXXXXXXXXXXXXXXXXXXXXXXXXXXXXXXXX-----XXXXXXXXXXXXXXXXX------S---XXXXXXXXXXXXXXXXXXXXXX