----------------------------------------------------------------------------------------------------
----------------------------------------------------------------------------------------------------
----------------------------------------------------------------------------------------------------
----------------------------------------------------------------------------------------------------
-----------------------------------------------xxxxxxxxxxx----------E-E------------------xxxxxx-----
-------------------SSS?SSS--------QQ?---------xx--QQQ?QQQ-x-------SSSSSSS-SS-xxxx-----xxxx-?SS-x----
---------------------------------------------xx------------x-------------E--xx---x---xx--E------x---
--------------------------------------------xx------E-------x--------------xx-----x-xx---XX------x--
----------------------------------SSS-----xxx-----SSSSSSS----x-----------xxx-------xx----XX-------x-
--B----------------SSSSSSS-------xxxx----xx<>--------------E--x---------xx<>-------<>----XX--------x
Qooo----------------------------xx---x--xx-[]-------X------X---x---E---xx-[]-------[]----XX---------
xxxxxx----xxx----------xxxxxxxxxx-----xxx--[]-------X------X----x-----xx--[]-------[]----XX---------
x-----xxxxxE-xxxxxxxxxxx---x---x-------x---[]----E--X------X-----xxxxxx---[]-------[]----XX-----Q---
X-----XXXXXXXXXXXXXXXXXX-X-X---X-------XXXXXXXXXXXXXXXXXXXXXXXXXXXXXXXXXXXXX-------XX-XXXXX---XXXXXX