----------------------------------------------------------------------------------------------------
----------------------------------------------------------------------------------------------------
----------------------------------------------------------------------------------------------------
----------------------------------------------------------------------------------------------------
----------------------------------------------------------------------------------------------------
-------------------Q------------------xxxxS----------XX---------------------------------------------
-------------------------------------xx--xxx---------[]---------------------------------------------
------------------------------------xx------x--------[]---------------------------------------------
xxx--------------------------------xx----E-EExx------[]---------------------------------------------
<>-x---------Q---S?SQSS----E------xxX--------X-xx----<>SSSSSS---------------------------------------
[]--x---------------------<>-----xxXXX-------X-X-x----------------------------xxxx--------------E---
>]---x--------------E-----------xxXXXX-------X-XX-x---Exxx-----------------B-xx<>-x---B----B--------
]]-E-ExxxxxxxxxxxxxxxxxxxxxxxxxxxXXXX--------X-XXX-xxxxxE-xxxxxxxxxxxxxxxxxxxx-[]--xxxxxxxxxxxxxxxxx
XXXXXXXXXXXXXXXXXXXXXXXXXXXXXXXXXXXXX--------X-XXXXXXXX<>XXXXXXXXXXXXXXXXXXXXXXXXXXXXXXXXXXXXXXXXXXX