-------------------------------------------------------------------------------------------x--------
-------------------------------------------------------------------------------------------x--------
-------------------------------------------------------------------x------------------------SSSSSSSS
-------------------------------------------------xxx----------------x-----------------------------XX
-----xxx------xxxxx--------------------xxxx----xxx--x---------------------------------------------XX
----xx--x----xxXX--x------------------xx---x--xxXS---x------------------------------------E----QQQQQ
---xx----x--xxXXX---x----------------xx-----xxxEX-----x----------------------------------<>---------
--xx------xxxXXXX----x--------------xx-------xXXX------x---------------------------------[]---------
xxx--------xXXXXX-----x----------xxxx--------XXXXS------x--------------------------------[]---xxxxxx
x<>-------XXXXXXX---S--x---------xx<>-------XXXXX--------x-x-------------------xxxx-----SXSS-xxSSSSS
-[]------XXXXXXXX-------x-------xx-[]------XXXXXX---------x-x-----------------xx---xxx------xx-SSSSS
-[]-----XXXXXXXXX--------xx----xx--[]-----XXXXXXX------------x-------xxxxx--xxx---<>->x----xx--SSSSS
-[]----XXXXXXXXXX--------X-xxxxx---[]----XXXXXXXX---------X-ooxxxxxxxxE---x-xx----[]-]-xxxxx---SSSSS
XXXXXXXXXXXXXXXXXXXXXXXXXXXXXXXXXXXXXXXXXXXXXXXXXXXXXXXXX-XXXXXXXXXXX<>----xx-----XXXXXXXXXX---XXXXX