----------------------------------------------------------------------------------------------------
------xxx-------------------------------------------------------------------------------------------
]--[]SSSS-----------------------SSSSSSSSSSSSSSSSSSSSSSSSSSSSSSSSSSSSSS[]S-SSSSSSSSSSSSSSSSSSSSSSSSSS
]--[]SSSS-----------------------------------------SSSSSSSSSSSSSS------[]-----SSSSSSSSSSSSSSSSSSSSSS-
---[]SSSS-----------------------------------------SSSSSSSSSSSSSS-------------SSSSSSSSSSSSSSSSSSSSSS-
---[]SSSS--------xxxxx----------------------------SSSSSSSSSSSSSS-------------SSSSSSSSSSSSSSSSSSSSSS-
---[]SSSS-------xx-<>-x-----------------------------------------------------------------------------
---[]SSSS------xx--[]--x--------------------------------------------------------------------------xx
---[]SSSS---xxxx---[]---x-------------------------xxx-----xxxxxxx-----------xxx---xx---xxxxxxxxxxxx-
xxx[]SSSS--xx-<>--QQQ?---x-----------------------xx--xxxxxx-<><>-x---------xx--xxxS-x-xx<><>SSSSSSS-
SSSSSSSSS-xx--[]------<---x--------XX-----X-----xx---SSSSSS-[][]--x-------xx---SSSS--xx-[][]SSSSSSS-
SSSSSSSSSxx---[]------[----xx-----XXXxxx-XXxxx-xx----SSSSSS-[][]---x-----xx----SSSS--XXX[][]SSSSSSS-
SSSSSSSSSx----[]------[----X-xxxxxxxxx--xxxx--xx----------X-[][]----xxxxxx---x-----EEXXX[][]SSSSSSS-
XXXXXXXXXXX---XX------X---XXXXXXXXXXXX--XXXX--XX----XXXXXXX-XXXXXXEXXXXXXX----XXXXXXXXXXXXXXXXXXXXXX