----------------------------------------------------------------------------------------------------
----------------------------------------------------------------------------------------------------
----------------------------------------------------------------------------------------------------
o------------------------------------------------------------------------------------------------o--
-----------------------------------------------------------------xxxxx------------------------------
------------xxx-------------------------------------------------xxXXX-x------------------------SSS--
-----------xxX-x-----------------------------------------------xx-XXX--x----------------------------
----------xxXX--x------------X-------------------S------------xx--XXX---x-------------------xxxxxxxx
---------xxXXX---x----------XX----------xxxx-----------------xxXX-XXX----x----------------xxx---x---
--------xxXXXX----x--------XXX---------xx<>-x---------------xxXXX-XXX-----x-------SSS----xx<>---S---
-------xxXXXXX-----x-------XXX--------xx-[]--x-------------xxXXXX-XXX------x------------xx-[]-------
xxx---xxXXXXXX------x---XXXXXX-------xx--[]---x-------xxxxxxXXXXX-XXX-------xxx--------xx--[]-------
XX-xxxxXXXXXXX-------xxxxxxxxxxxxxxxxx---[]----xxxxxxxx---xXXXXXX-XXX-------XX-xxxxxxxxx---[]----E--
XXXXXXXXXXXXXXXXXXXXXXXXXXXXXXXXXXXXXXXXXXXXXXXXXXXXXXX--XXXXXXX--XXXXXXXXXXXXXXXXXXXXXXXXXXXXXXXXXX