----------------------------------------------------------------------------------------------------
----------------------------------------------------------------------------------------------------
SSSSSSSSSSSSSSSSSSSSSSSSSSSS--------------------------?---------------------------------------------
SSSSSSSSSSSSSSSSSSSSSSS-----------------------------------------------------------------------------
SSSSSSSSSSSSSSSSSSSSSSS-----------------------------------------------------------------------------
SSSSSSSSSSSSSSSSSSSSSSS------xxxx--------------------S--------------------------------------xxx-----
----------------------------xx---x---------------------------------------------------------xxX-x----
-----xxx--------------xxx--xx-----x-------------------------------------------------------xxXX--x---
xxxxxx?-xxxxxxxxxxxxxxx--xxx-------x-----------xxxxxxxxx------------xx-------------------xxXXX---x--
SSSSSS??SSSSSSSSSSSSSSS--QQQ--------x-xxxxx---xx-XXXXXX-x----xxxx--xx-x-----------------xxXXXX----x-
-SSSSS--SSSSSSSSSSSSSSS--------------xx----x-xx----------x--xx---xxx---x---------------xxXXXXX-----x
-SSSSS--SSSSSSSSSSSSSSS---------<>---<>-----xx------------xxx-----x-----xx------------xxXXXXXX------
oSSSSSooSSSSSSSSSSSSSSS---------[]---[]-----<>-------------x------X-----X-xxxxxxxxxxxxxXXXXXXX------
XXXXXXXXXXXXXXXXXXXXXXXXXXXXX---[]---[]-----[]-----------XXX------X-----XXXXXXXXXXXXXXXXXXXXXXXXXXXX