--------------------------------------------------------------------------------------xxxxx---------
-----------------------------------------------xxxxxxxxxxxxxxxxxxxxxxxxxxxxxxxxxxxxxxxx----xxxxxxxxx
---------------------------------------------xxxSS????SSSSSSSSSSSSSSSSSSSSSSSSSSSSSSSSS----SSSSSSSSS
------------------------------------------xxxxSS-------------------------------------------SSSS-----
ooo---------------------------------------xSSS---------------------------------------------SSSS-----
SSSSSSSSSS--------------------------------x------------------------------------------------SSSS----E
-----------------------------------------xx-------------------------------------------------------<>
----------------------------------------xxS-------------------------------------------------------[]
-------xxxx-------ooo-----------------xxx-------XXXXX---------------------------XXX----------E----[]
------xx--xxx-----ooo----------------xx<>------XXXXXX------------------XXX------------------<>---?SS
x----xx------x----------------------xx-[]-----XXXXXXX----------XXX--------------------------[]------
-x--xx--------x--------------------xx--[]----XXXXXXXX---XXX---------------------------------[]------
--xxx----------xxxxxxxxxxxxxxxxxxxxx---[]---XXXXXXXXX---------------------------------------[]------
XXXXX------S---XXXXXXXXXXXXXXXXXXXXXXXXXXXXXXXXXXXXXXX---------------------------------XXXXXXXXXX---