----------------------------------------------------------------------------------------------------
----------------------------------------------------------------------------------------------------
----------------------------------------------------------------------------------------------------
-----------------------xxx--------------------------------------------------------------------------
-------------xxxx----xxx--x-------------------------------------------------------xxxx--------------
------------xx---x--xxXS---x-----------------------------------------------------xxXX-x-------------
-----------xx-----xxxEX-----x---------------------------------------------------xxXXX--x------------
----------xx-------xXXX------x-------------------------------------------------xxXXXX---x-----------
--------xxx--------XXXXS------x------------------B--------E-------------------xxXXXXX----x----------
-------xx<>-------XXXXX--------x---------B-------b-------->------------------xxXXXXXX--S--x---------
o-----xx-[]------XXXXXX---------x--------b--?-B----------o]---?QQ-----------xxXXXXXXX------x--------
o----xx--[]-----XXXXXXX----------x-------B----b------S----X----------------xxXXXXXXXX-------xx------
xxxxxx---[]----XXXXXXXX---------X-xxxxxxxxxxxxxxxxxxxxxxxxxxxxxxxxxxxxxxxxxxXXXXXXXXX-------X-xxxxxx
XXXXXXXXXXXXXXXXXXXXXXXXXXXXXXX-XXXXXXXXXXXXXXXXXXXXXXXXXXXXXXXXXXXXXXXXXXXXXXXXXXXXXXXXXXXXXXXXXXXX