----------------------------------------------------------------------------------------------------
----------------------------------------------------------------------------------------------------
----------------------------------------------------------------------------------------------------
----------------------------------------------------------------------------------------------------
-------xxxxxxxxxxx----------E-E-----------------------------------------------------------xxxxx-----
------xx--QQQ?QQQ-x-------SSSSSSS-SS-xxxx-----xxxxx------------------------------------E-xxXXX-x----
-----xx------------x-------------E--xx---x---xx-<>-x-----xxxx---------------------------xxXXXX--x---
----xx------E-------x--------------xx-----x-xx--[]--x---xx---x-xxxxx----xxx------------xxXXXXX---x--
--xxx-----SSSSSSS----x-----------xxx-------xx---[]---x-xx-----xx----x-xxx------------xxxXXXXXX----x-
Bxx<>--------------E--x---------xx<>-------<>---XXX---xx------<>-----xx<>--x--------xx<>XXXXXX-----x
xx-[]-------X------X---x---E---xx-[]-------[]---------<>------[]----E<>[]---x------xx-[]XXXXXX------
x--[]-------X------X----x-----xx--[]-------[]---------[]------[]---<>[][]----x----xx-X[]XXXXXX------
---[]----E--X------X-----xxxxxx---[]-------[]---------[]-E----[]---[][][]-----xxxxx-XX[]XXXXXX------
XXXXXXXXXXXXXXXXXXXXXXXXXXXXXXXXXXXX-------XX-XXXXXXXXXXXXXXXXXXXXXXXXXXXXXXXXXXXXXXXXXXXXXXXXXXXXXX