-------------xxx--------xxx---------xxx-------------------------------------------------------------
------------xx--x------xx--x-------xx--x------------------------------------------------------------
-----------xx----x----xx----x-----xx----x------------------------SSSSSSSSSSSSSSSSSSSSSSSSS?SSSSSSSSS
----------xx------x--xx------x---xx------x-xxx-----------------------------------------------------S
--------xxx--------xxx--------xxxx--------xx--x----------------------------------------------------S
-------xxXX--------XXX--------XXXX--------XX---x---------------------------------------------------S
------xxXXX--------XXX--------XXXX--------XX----x-----------------------------------------xxxxx----S
-----xxXXXX--------XXX--------XXXX--------XX-----x------------------------------------xxxxx----x---S
----xxXXXXX--------XXX--------XXXX--------XX------x----------------------------------xxXXXX-----xx-S
xx-xxXXXXXXS-------XXX--------XXXX--------XX-------x-------------------------xxxx---xxXXXXX----<>-x-
X-xxXXXXXXX--------XXX--------XXXX--------XX--------x-----xxx----QQQQQQSQ---xx---x-xxXXXXXX----[]--x
X->XXXXXXXX--------XXX--------XXXX--------XX---------x---xxB-x-------------xx-----xxXXXXXXX----[]---
X<]XXXXXXXX--------XXX--------XXXX--------XX----------xxxx-b--xxxxxxxxxxxxxxX-----XXXXXXXXX----[]---
XXXXXXXXXXXXX------XXX--------XXXX--------XXXXXXXXX---XXXXXXXXXXXXXXXXXXXXXXX-----XXXXXXXXX--XXXXXXX