----------------------------------------------------------------------------------------------------
---E------------------------------------------------------------------------------------------------
S?SSSSSSSSSSSSSSSSSSSSSSSS------------------x------------------XXX------------xxx-------------------
---------------------------------------------------------------[]---------xxxxx--x------------------
----------------------------XXX--------------------------------[]-------xxx--->---x-----------------
QQ------------------------------------E-----XXX---------------X<>------xx<>--------x----------------
----------------------------------------------------------------------xxX[]---------x---------------
----------------------------------------------------------------E-----xXX[]----------x--------------
xxx--------------------xxxxx-----SSSSS??-x--------------------------xxxXX[]-----------xxxxx---------
SS-x-----xxxx---------xxXXX-xxxx------------------------------xxxx-xx<>XX[]------------xXX-x--------
SS--xx--xxSS-x-------xxEXXX-XXX-x----------------------------xx---xxX[]XX[]------------XXX--x-------
SS----xxx-SS--x-----xxXXXXX------x------xxxx--------xxxx----xx---<>XX[]XX[]------------XXX---x------
S------x--SS---xxxxxxXXXXXX-------xxxxxxx---xxxxxxxxx---xxxxx----[]XX[]XX[]-----------XXXX----xxxxxx
X---XXXX--XX--XXXXXXXXXXXX-------XXXXXXXX---XXXXXXXXX---XXXXX----[]XXXXXXXXXXXXX--XXXXXXXXXXXXXXXXXX