------------------------------------------------------------------------------------------------x---
----------------------------------------------------------------------------------------------------
SSSSSSSSSSSSSSSSSSSSSSSSSSSSSSSSSSSSSSSSSSSSSSSSSSSSSSSSSSS-----------------------------?-----------
----------------------------------------------------------------------------------------------------
-------------------------------------------------------------XXX------------------------------------
------------S--------------------------------------------------------------------------S----X-------
------------S-------------xx------------------------------------------------------------------------
------------S------------xx-x-xxx-------------------------------------------------------------------
x-------ooooS-----------xx---xx--x----------------------xxxxx-------xx-----------xxxxxxxxxx---------
-xx-----SSSSS---------xxx----<>---x------xxxx----------xxXXX-xxxx--xx-x-xxxxx---xx-XXXXXXX-x----XX--
XX-xx----------------xx<>----[]----xxx--xxSS-x--------xxEXXX-XXX-xxx---xx----x-xx-----------x--xx---
XXXX-x--------------xx-[]----[]----<>-xxx-SS--x------xxXXXXX------x----<>-----xx-------------xxx-x--
XXXX--xxxxxxxxxxxxxxx--[]----[]--E-[]--x--SS---xxxxxxxXXXXXX-----<>----[]-----<>--------------x---xx
XXXXXXXXXXXXXXXXXXXXXXXXXXXXXXXXXXXXXXXX--XX--XXXXXXXXXXXXX------[]----[]-----[]------------XXX--XXX