------------xxxxx-----------------------------------------------------------------------------------
xxxxxxxxxxxxx----xxxxxxxxxxxxxxxxxxxxxxxxxxxxxxxxxxxx-----------------------------------------------
SSSSSSSSSSSSS----SSSSSSSSSSSSSSSSSSSSSSSSSSSSSSSSSSS-x---SSSSSSSSSSSSSSSS-------------------SSSSSSSS
-----------------SSSSSSS------------------------------x--SSSSS------------------------------SSSSSSSS
-----------------SSSSSSS-------------------------------x-SSSSS------------------------------SSSSSSSS
-----------------SSSSSSS----E---------------------------xSSSSS------------xx--xxxxx---------SSSSSSSS
---------------------------<>----------------------------x---------------xx-xxx----x-----xxxx-------
---------------------------[]------------E----------------x-------------xx--XXX-----x---xx---x------
-------------------E-EE----[]-----------<>----------------oxxx------xxxxx------------x-xx----oxxxxxx
-----XXX----------<><>>---?SSS--E-------[]---------E-----S?SS-x----xx-XXX-------------xx----S?SSSSSS
------------------[][]]--------<>-------[]--<>----<>-----SSS---x--xx-----------SSS-S--[>----SSSSSSSS
------------------[][]]--------[]---<>--[]--[]----[]-----SS-----xxx------------SSS-S--[]----SSSSSSSS
?-----------------[][]]--------[]---[]--[]--[]----[]-------E-EE--xX------------SSS-S--[]----SSSSSSSS
X-----------------XXXXXXXX----XXX---XX--XX--XX--XXXXXXXXXXX-XXXXXXX---------XXXSSS-S--XXXXXXXXXXXXXX