xxx-------------------------------------------------------------------------------------------------
x--x------------------------------------------------------------------------------------------------
----x-----------------------------------------------------------------------------------------------
<----x----------------------------------------------------------------------------------------------
[-----x---------------------------------------------------------------------------------------------
b------x------------SSSS---------------------------------------------SSSSSSSS-----------------------
]-------x------------[]-----------------xxxx------------------------S-------------------------------
]--------x-----------[]----------------xx---xxx--------------------SS------------------------------x
]---------x----------[]---------------xx-----x-x------------------SSS---------------xxxx----------xx
]----------xx--------[]----------xxxxxx------S--xS---------------SSSS--------------xx<>-x--------xx-
>-----E----B-x-------<>---------xxE--x-----------x--------------------------------xx-[]--x------xxE-
S----<>----b--x------xxx-------xx<>-XX------------x-----xxx-----xxx-------xxxx---xx--[]---x----xx<>-
S----[]----B---xxxxxxxE-xxxxxxxx-[]-XX-------------xxxxxxE-xxxxxxB-xxxxxxxx---xxxxE--[]----xxxxx-[]-
XX--X[]XXXXXXXXXXXXXXXXXXXXEXXXXXXXXXX-------------XXXXX<>XXXXXXXXXXXXXXXXX---XXXXXXXXXX---XXXXXXXXX