--------------------------------------------------
--------------------------------------------------
--------------------------------------------------
--------------------------------------------------
--------------------------------------------------
SS---------------xxxxx----------------------------
-[--------------xx-<>-xx--------------------------
-[-------------xx--[]---x-------------------------
x[xx---------xxx---[]----x-----------------------x
-<>-x-------xx<>--QQQ?----x------------------xxxxx
Xx]--x-----xx-[]-----------x-------xxxx-----xxXXXX
--]---x---xx--[]------------x-----xx<>-x---xxXXXXX
--]----xxxx---[]------E------xxxxxx-[]--xxxxXXXXXX
XXXXXXXXXXXXXXXXX-----X----XXXXXXXXXXXXXXXXXXXXXX-