----------------------------------------------------------------------------------------------------
----------------------------------------------------------------------------------------------------
-SSSSSSSSSSSSSSSSSSSSSSSS-SS---xx-------------------------------------------------------------------
-S--SSSSSSS-------------------xx-x------------------------------------------------------------------
SS--SSSSSSS-------xxx--------xx---x-----------xxxxx------------------xxxxx--------------------------
SS--SSSSSSSSxxxxxxx--x------xx-----xxxxxxxxxxxx----xxxxxxxxxxxxxxxxxxx----xxxxxxxxxxxxxx---------E--
S----------xxSSSSSS---xxxxxxx------SSSSSSSSSSSS----SSSSSSSSSSS>SSSSSSS----SSSSSSSSSSSSX-x-----------
Sxxx------xx-SSSSSS--SSSSSSSS---------------------------------]-----------------------X--x---E------
xx--xxxxxxx--SSSSSS--SSSSSS-----------------------------------]-----------------------X---x---------
SS--SSSSSSS--SSSSSS--SSSSS----------------E-------------------Q?-E--------------------X--E-x--------
SS---------------------------S-----------<>------S-------SS-----<>------S------------?X-<>--x-------
SS-----------------<>--------S-----------[]---------------------[]----------------E---X-[]---x------
SS-----------------[]--------S-----------[]---------------------[]---------------<>---X-[]----x---xx
XXXXXXXXXXXXXXXXXXXXXXXXXXXXXS-----------[]------------------QQQXXXXXX-----------[]---X-[]-E---xxxx-