----------------------------------------------------------------------------------------------------
----------------------------------------------------------------------------------------------------
----------------------------------------------------------------------------------------------------
----------------------------------------------------------------------------------------------------
----------------------------------------------------------------------------------------------------
---E--S----xx--------------------------------------------------------------------xxx----------------
--<>---------x------------------------------------------------------------------xxX-x---------------
--[]----------x----------------------------------------------------------------xxXX--x--------------
--[]-----------------------xxxx--------------------------xx-------------------xxXXX---x----------xxx
SSXXS------------xxx------xx<>-x------------------xxxx--xx-x-----------------xxXXXX----x--------xxQQ
-----xxxx-------xxX-x----xx-[]--x----QQQQQQ?-----xx---xxx---x---------------xxXXXXX-----x------xx---
x---xx<>-x-----xx-X--x--xx--[]---x--------------xx-----x-----xx-----------[xxXXXXXX------x----xx----
-xxxx-[]--xxxxxx--X---xxx---[]----xxxxxxxxxxxxxxxX-----X-----X-xxxxxxxxxxxxxXXXXXXX-------xxxxx--X--
XXXXXXXXXXXXXXXXXXXXXXXXXXXXXXXXXXXXXXXXXXXXXXXXXX-----X-----XXXXXXXXXXXXXXXXXXXXXXXXXXXXXXXXXXXXXXX