----------------------------------------------------------------------------------------------------
----------------------------------------------------------------------------------------------------
----------------------------------------------------------------------------------------------------
----------------------------------------------------------------------------------------------------
------------------------------------------------------------------------------------------------xxxx
------------------------xxxx------------------XX-----------------------------------------------xxXX-
------------------------x<>-x-----------------[]---------------------------------------x-x----xxXXX-
------------------------x[]--x----------------[]--------------------------------------xx--x--xxXXXX-
oo----------------E----xx[]---x----xxxx-------[]-------------------------------------xx----xxxXXXXX-
-o--------------------xxS[]----x--xx---xx-----<>SSSSSS------------------------------xx--x---xXXXXXX-
--------------oo-----xx--[]-----xxx----X-x----------------------------Q?QQQ--B-----xx-------XXXXXXX-
--------------oo----xx---[]------x-----XX-xx---Exxx--------------------------b----xx<>-----XXXXXXXX-
xxxxxxxxxxxxxxxxxxxxx----[]------B-----XXXX-xxxxxE-xxxxxxxxxxxxxxxxxxxxxxxxxxxxxxxx-[]----XXXXXXXXX-
XXXXEEXEXXXXXXXXXXXXXXXXXXXXXXXXXX-----XXXXXXXXX<>XXXXXXXXXXXXXXXXXXXXXXXXXXXXXXXXXXXXXXXXXXXXXXXXXX