----------------------------------------------------------------------------------------------------
----------------------------------------------------------------------------------------------------
----------------------------------------------------------------------------------------------------
----------------------------------------------------------------------------------------------------
-----------------------------------------------------------------------------E----------------------
QSSS--------------------------------------------------------------SSSSSSSSSSSSSSS-------------------
----------------------------------------------------------------------------------------------------
----------------------------------------------------------------------------------------------------
xxx---------------------------------B----------------------------------------E-------X--------------
EX-x-----------QQQQ-----------------b--------------------------------xxxx----QQ?QQQQQX--------------
XX--x-------B---------B-----E---B-------?QQ------------B------------xx<>-x--------------------------
XX---x------B--E------b---------b-----------------Q----b--xxx------xx-[]--x------E----------xxx-----
XEE---xxxxxxxxxxxxxxxxxxxxxxxxxxxxxxxxxxxxxxxxxxxxxxxxxxxxx--xxxxxxx--[]---xxxxxxxxxxxxxxxxxx-Exxxxx
XXXXXXXXXXXXXXXXXXXXXXXXXXXXXXXXXXXXXXXXXXXXXXXXXXXXXXXXXXX--XXXXXXXXXXXXXXXXXXXXXXXXXXXXXXXX--XXXXX