-----------------------------------------------------xxx--------------------------------------------
----------------------------------------------------xx--x-------------------------------------------
---------------------------------------------------xx----x------------------------------------------
--------------------------------------------------xx------x-----------------------------------------
------------------------------------------------xxx--------x----------------------------------------
-----------------------------------------------xxXX---------x---------------------------------------
----------------------------------------------xxXXX------XXX-x--------------------------------------
---------------------------------------------xxXXXX-----------x-------------------------------------
--------------------------------------------xxXXXXX------------x--------------------S---------------
-----------------------xxx-----------------xxXXXXXXS------------x--------------------------xxx------
----------------------xxX-x---------------xxXXXXXXX--------------x--------xxxx-----xxx----xxX-x----x
E------xxxxx-xxx-----xx-X--x-------------xxXXXXXXXX---------------x------xx<>-x---xxS-x--xx-X--x--xx
xxxxxxxx----xx--xxxxxx--X---xxxxxxxxxxxxxxXXXXXXXXX--------------XXxxxxxxx-[]--xxxx-S--xxx--X---xxx-
XXXXXXXX---XXX--XXXXXXXXX--XXXXXXXXXXXXXXXXXXXXXXXXXX------------XXXXXXXXXXXXXXX<>XXXXXXXXXXXXXXXXXX