----------------------------------------------------------------------------------------------------
----------------------------------------------------------------------------------------------------
----------------------------------------------------------------------------------XXXX--------------
-----------------------------------------------------------------------------------[]---------xxxx--
----------------------xxxxxx--------------------------xxxx-------------------------[]-------xxx---x-
---------------------xx?SSS-x------------------------xxXX-x------------------------<>------xx<>----x
---------------------x-------x----------------------xxXXX--x------------------------------xxX[]-----
xxx-------------xxxxxx--------x-------------------xxxXXXX---x-----------------------E-----xXX[]-----
EE-x-----------xx---xE-------E-x-------------xx--xxxXXXXX----x--------------------------xxxXX[]-----
>>--x---------xx----<>---E--<>--x-----xxxx--xx-xxx-XXXXXX-----x-------------------xxxx-xx<>XX[]-----
[]---x------xxx-----[]--<>--[]---x---xx---xxx---x--XXXXXX------x-----------------xx---xxX[]XX[]-----
[]----x----xx<>-----[]--[]--[]----x-xx-----x----X-XXXXXXX-------xx-------------Exx---<>XX[]XX[]-----
Q]-----xxxxx-[]--E--[]--[]--[]-----xx------X----XXXXXXXXX-------X-xxxxxxxxxxxxxxx----[]XX[]XX[]-----
XXX--XXXXXXXXXXXXXXXXXXXXXXXXXXXXXXXX------X----XXXXXXXXXXXXXXXXXXXXXXXXXXXXXXXXX----[]XXXXXXXXXXXXX