----------------------------------------------------------------------------------------------------
----------------------------------------------------------------------------------------------------
SSSSSSSSSSSSS--------------SSS-[]SSSSSSSS-SSSS----------------------------------------SSSSSSSSSSSSSS
-------------------------------[]SSSSSSSS-SSSS------------------------------------------[]----S-----
---xE----------x---------------[]SSSSSSSS-SSSS------------------------------------------[]----S---x-
---QQQ--------xx---xxxxx-------[]SSSSSSSS-SSSS----------------------------xxx-----------[]----S---xx
-------------xx-xxxx----x------[SSSSSSSSS-SSSS-----------------------E----x--x----------<>----S---x<
------------xx---XXX-----x-----[SSSSSSSSS-SSSS---------------------------XX---x---------------S---x[
--xxxxxxxxxxx-------------x----]SSSSSSSSS-SSSS--------------------------XXX----x-------------oS--xx[
-xxSSSSXXXXXX--------------xxxx]SSSSSSSSS-SSSS-------E--EE--------E----XXX------x------------SS-xxS[
xx-SSS--------------SSS-S--SSSSSSSSSSSSSS-SSSS------<>--<>-----------------------x-------------xx--[
x--SSS--------------SSS-S--SSSSSSSSSSSSSS-SSSS--<>--[]--[]------------------------x----xxx----xx---[
---SSS--------------SSS-S--SSSSSSSSSSSSSS-SSSS--[]--[]--[]-----------------------X-xxxxx--xxxxx----[
X--XXX-----------XXXSSS-S--XXXXXXXXXXXXXXxXXXX--XX--[]--[]-------------------XXXXXXXXXXX--XXXXXXXXXX