--------------------------------------------------------------------------------------------xxx-----
-----------------------------------------------------------------------xxxxxxxxxxxxxxxxxxxxxx--x----
SSSSSSSSSSSSSSSSSSSSSSSSSSSSSSSSS?SSSSSSSSSSSSSSSSSSSS?SSSSSSS-SSSSSSS-xXXXXXXXXXXXXXXXXXXXXX---x---
-SSS--SSS------SSSS-------SS----------S--SSSS-------------------------xxXXXXXXXXXXXXXXXXXXXXX----x--
-SSS--SSS--E---SSSS-------SS--------E-S--SSSS------------------------xx-XXXXXXXXXXXXXXXXXXXXX-----x-
SSSS-------SS----------ooo----------SS-----------oooooo--------------xS-XXXXXXXXXXXXXXXXXXXXX------x
S----------SS-----------------------SS-------------------------------x--XXXXXXXXXXXXXXXXXXXXX-------
S-----S----SS----------SSS----------SS-----------SSSSSS-------------xx--XXXXXXXXXXXXXXXXXXXXX-------
SE----So??-SS---E------SSS----------SS----E------SSSSSS------------xxS--XXXXXXXXXXXXXXXXXXXXX-------
SSSS--SSS--SS--SSSS-------SS--------SSS--SSSS----------------------x----XXXXXXXXXXXXXXXXXXXXX-------
--------------EE----------SS----------S-EE------------------------xx----XXXXXXXXXXXXXXXXXXXXX-------
EXXX--------------xxxxx---SS----------S-----xxxxx----------------xx---E-XXXXXXXXXXXXXXXXXXXXX-------
xxxxxxxxxxxxxxxxxxx----xxxxxxxxxxxxxxxxxxxxxx----xxxxxxxxxxxxxxxxx------XXXXXXXXXXXXXXXXXXXXX-------
XXXXXXXXXXXXXXXXXXX---XXXXXXXXXXXXXXXXXXXXXXX---XXXXXXXXXXXXXXXXXXXXXXXXXXXXXXXXXXXXXXXXXXXXX--XXXXX