----------------------------------------------------------------------------------------------------
----------------------------------------------------------------------------------------------------
-----------------------------------------------------------------xxxx-----------------E-----SSSSSSSS
----------------------------------------------------------------xx---x----------------------[-------
-------------------------------------E-------------------------xx-----x----xxxxx------------[-------
-------------------------xxxx-------SQS--SQS------------------xx-------x--xxXXX-x-----------[-------
------------------------xxXX-x------------------------------xxx---------xxxXXXX--x---------[]-------
-----------------------xx-XX--x-----------------------o-----xXX----------xEXXXX---x--------[]-------
----------------------xx--XX---x-----------------------E----xXX----------XXXXXX----x---------------x
-------------X--------x---XX----x---SQS--S?S--------SSSSS--xxXX---------XXXXXXX-----x-------------xx
Bxxxx--------X-------xx---XX-----x---------------E--E-----xxXXX-------EXXXXXXXX------x-----------xx-
xx<>-x---B---X------xx----XX------x---------------------Exx-XXX-------XXXXXXXXX-------xxx-------xx--
x-[]--xxxxxxxxxxxxxxx--E--XX------Exxxxxxxxxxxxxxxxxxxxxxx--XXX------XXXXXXXXXX-------XX-xxxxxxxx---
XXXXXXXXXXXXXXXXXXXXXXXXXXXXXXXXXXXXXXXXXXXXXXXXXXXXXXXXXXXXXXX---XXXXXXXXXXXXXXXXXXXXXXXXXXXXXXX---