--------------------------------------------------
--------------------------------------------------
SSSSSSSSSSSSSS------------SSSS--------SSSSSSSSSSSS
-S------------------------------------------------
-S----------------------------------------xxx-----
-S------------xx--xxxxx------------xxxxxxxx--xx---
--------------x-xxx----x----------xxSSSSSSS--S-x--
-------------xx-XXX-----x--------xx-SSSSSSS-----x-
xxx------xxxxx-----------x------xx--SSSSSSS------x
SS-x----xx-XXX---------S--xxxxxxSS--SSSSSSS-------
S---x--xx----------SSS-S--SSSSSSSS-------S--------
S----xxx-----------SSS-S--SSSSSSSS-------S--------
E-EE--xX-----------SSS-S--SSSSSSSS--------o?------
XXXXXXXX--------XXXSSX-S--XXXXXXXXXXXXXXXXXE------