----------------------------------------------------------------------------------------------------
----------------------------------------------------------------------------------------------------
SSS---SSSSSS--[]SSSSSSSSSS----------------------------------------------------------XXXX------------
--------------[]SSSSSSSSSS------------------------------------xxxx-------------------[]--------xxxxx
--------------[]SSSSSSSSSS----------------------------------xxx---x------------------[]-------xx----
?-xx----------[]SSSSSSSSSS----------------------SSSSS------xx<>----x-----------------<>------x<>----
-xx-x---------[]SSSSSSSSSS--------------------------------xxX[]-----x-----------------------xx[]----
xx---x--------[]SSSSSSSSSS-------------------------------xxXX[]------x----------------E-----xX[]----
x-----x--------]SSSSSSSSSS-----------------------E-----xxxXXX[]-------xxxxxxx-------------xxxX[]----
S------x-xxxxx-]SSSSSSSSSS----------------------SSSSS-xx<>XXX[]--------xSSSSX-------xxxx-xx<>X[]----
--------xxSSSSSSSSSSSSSSSS----------------xxxx-------xx-[]XXX[]---------S-SS-------xx---xxX[]X[]----
o-------<>SSSSSSSSSSSSSSSS---------------xx<>-x-----xx--[]XXX[]---------S-SS------xx---<>XX[]X[]----
o-------[]SSSSSSSSSSSSSSSSxxxxxxxxxxxxxxxx-[]--xxxxxx--X[]XXX[]-------X-S-SSxxxxxxx----[]XX[]X[]----
XX----XXXXXXXXXXXXXXXXXXXXXXXXXXXXXXXXXXXXXXXXXXXXXXXXXXXXXXXXXXXXXXXXXXXXXXXXXXXXX----[]XXXXXXXXXXX