--------------------------------------------------
--------------------------------------------------
--------------------------------------------------
-----------------------------------o--------------
--------------------------------------------------
----xxxxx------------------------SSS-------E------
---xxXXXXx--------------------------------<>------
--xxXXXXX-x-------------------xxxxxxxxx---[]------
xxxXXXXXX--x----------------xxx---x----xx-XXX-----
-x-XXXXXX---x-------SSS----xx<>---S---<>-x--------
-XXXXXXXX----x------------xx-[]-------[]--x-xxxxxx
-XXXXXXXX-----xxx--------xx--[]-------[]---xx<><>-
XXXXXXXXX-----XX-xxxxxxxxx---[]----E--[]----x[][]-
XXXXXXXXXXXXXXXXXXXXXXXXXXXXXXXXXXXXXXXXXXXXXXXXXX