----------------------------------------------------------------------------------------------------
----------------------------------------------------------------------------------------------------
-------------------------?--------------------------------------------------------------------------
----------------------------------------------------------------------------------------------------
----------------------------------------------------------------------------------------------------
------------------------S----------------------------------SSSSSSSSSSS------------------------------
----------------------------------------------------------------------------------------------------
----XXX--------------------E-------------------------------------xxxx-------------------------------
---xxxx-----------xxxxxxxxxx--------------------xxx----------xxxxxSS-x------------------------------
--xx---x-xxxxx---xx-XXXXXXX-x----xxxx----------xx--x-------xxxSSSS----xx----QQQQ--Q----------------x
-xx-----xx----x-xx-----------x--xx---xxxxx----xx----x-----xx<>----------x--------------xxxx-------xx
xx------<>-----xx-------------xxx----XXXX-x--xx------xxx-xx-[]---------X-x------------xx<>-x-----xx-
xE------[]-----<>--------------x-----------xxx-------XX-xx--[]------E--X--xxxxxxxxxxxxx-[]--xxxxxx--
X-------[]-----[]------------XXX-----------XXX-------XXXXXXXXXXXXXXXXXXXXXXXXXXXXXXXXXXXXXXXXXXXXXXX