--------------------------------------------------
--------------------------------------------------
--------------------------------------------------
--------------------------------------------------
--------------------------------------------------
--------------------------------------------------
oo-----------oooo------------------oooo-----------
--------------------------------------------------
---------xxxx------------------xxxx---------------
--------xx<>-x----------------xx<>-x----------QQQ-
-------xx-[]--x---------E----xx-[]--x------------x
X-----xx--[]---x-------<>---xx--[]---x----------xx
xxxxxxx---[]----xxxxxxxxxxxxx---[]----xxxxxxxxxxx-
XXXXXXXXXXXXXXXXXXXXXXXXXXXXXXXXXXXXXXXXXXXXXXXXX-