----------------------------------------------------------------------------------------------------
----------------------------------------------------------------------------------------------------
SSSSSSSSSSSSSSSSSSSSSSSSSSSSSSSSSSSSSSSSSSSSS-------------------------------------------------------
----------------[-----------------------------------------------------------------------------------
----------------[-----------------------------------xxxxx-------------------------xxxxxxxxxxx-------
QQQQQQ----------<----------------------------------xxXXX-x-----------------------xx--QQQ?QQQ-x------
-------------------xx-----------------------------xxXXXX--x---------------------xx------------x-----
------------------xx-x-xxx----------------xxxxxxxxxXXXXX---x-------------------xx------E-------x----
-----------------xx---xx--x------xxx-----xxXXX-x-XXXXXXX----x----------------xxx-----SSSSSSS----x---
-E-SQSx--------xxx----<>---x----xx--x---xxXXXX-X-XXXXXXX-----x-------SSS----xx<>--------------E--x--
->------------xx<>----[]----xxxxx----x-xxXXXXX-XXXXXXXXX------x------------xx-[]-------X------X---x-
-]-----------xx-[]----[]----<>-x------xxXXXXXX-XXXXXXXXX-------xxx--------xx--[]-------X------X----x
xxxxxxxxxxxxxx--[]----[]--E-[]-X------XXXXXXXX-XXXXXXXXX-------XX-xxxxxxxxx---[]----E--X------X-----
XXXXXXXXXXXXXXXXXXXXXXXXXXXXXXXX------XXXXXXX--XXXXXXXXXXXXXXXXXXXXXXXXXXXXXXXXXXXXXXXXXXXXXXXXXXXXX