----------------------------------------------------------------------------------------------------
xxxxxxxxxxxxxxxxxxxxxxxxxxxxxxxxxxxxxxxx------------------------------------------------------------
SSSSSSSSSSSSSSSSSSSSSSSSSSSSSSSSSSSSSSS-x---SSSSSSSSSSSSSSSSS-------------SS---SSSSSSSSSS[----------
SS------------------------[--------------x--SSSS----------------------------------SSSSSS------------
SS------------------------[---------------x-SSSS----------------------------------SSSSSS--------xxxx
SS----E---------------E---[E---------------xSSSS--------------xx--xxxxx-------E---SSSSSS-------xx--Q
-----<>--------------<>---[>----------------x----------------xx-xxx----x------>SSSSSSSSS]-----xx----
-----[]-------------------[]-----------------x----------xx--xx--XXX-----x-----]SSSSSSSSS]----xx-----
E----[]-------------------<>-----------------oxx-------xx-xxx------------x----]SSSSSSSSS]xxxxx-----S
>---?SSS--E---------------[]----------------S?SS------xx--XXX-------------xxxx]SSSSSSSS[]SSSSS--S---
]--------<>----S----------[]---<>-----E-----SSS------xx------------SSS-S--SSSSSSSSSSSSSSSSSSSS------
]--------[]----S----------[]---[]----<>-----SS--xxx-xx-------------SSS-S--SSSSSSSSSSSSSSSSSSSS------
]--------[]----S----------[]---[]----[]-------E-EE-xxX-------------SSS-S--SSSSSSSSSSSSSSSSSSSS------
X--X----XXX----S----------XXX--XX--XXXXXXXXXXX-XXXXXXX----------XXXSSS-S--XXXXXXXXXXXXXXXXXXXXXXXXXX