--------------------------------------------------
--------------------------------------------------
--------------------------------------------------
--------------------------------------------------
--------------------------------------------------
--------------------------------------------------
--------------------------------------------------
------------xxxxxx-------------------------------x
--------xxxxx--<>-x-----------------------------xx
------xxx--<>--[]--x---------------------------xxX
-----xx<>--[]--[]---x-------------------------xxXX
x---xx-[]--[]--[]----x-----------------------xxXXX
-xxxx--[]--[]--[]-----xxxxxxxxxxxxxxxxxxxxxxxxXXXX
XXXXXX-XX--XX--XXXXXXXXXXXXXXXXXXXXXXXXXXXXXXXXXXX