----------------------------------------------------------------------------------------------------
----------------------------------------------------------------------------------------------------
----------------------------------------------------------------------------------------------------
-----------------------------------------------xxx--------------------------------------------------
---------------------------------------------xxx--x-------------------------------------------------
---------------xxxE-----oo------------------xxXX---x------------------------------------------------
oooooo---xxxxxxx--x-------------XX---------xx-XX----x-----------------------------------------------
--------xxXXXXXX---x---xxx----------------xxXXXX-----x----------------------------------------E-----
---xx--xx-----------xxxx--xxxxx----------xx-XXXX------x--------oo------------------------------XXX--
--xx--xx------------XXXX--XXXX-x--------xxXXXXXX-------x----------xxx-------------------------------
-xx--xx-------------------------x------xx-XXXXXX--------x--------xxX-x---xxxx-----------------------
xx---XXX-------------------------x----xx--XXXXXX---------x------xx-X--x-xx<>-x----------------------
x----------------ooo--------------xxxxx---XXXXXX--------X-xxxxxxx--X---xx-[]--xxxxxxxxxxxxxxxx------
X----------------XXX-------------XXXXXXXXXXXXXXXXXXXXXXXXXXXXXXXX-XXXXXXXXXX--XXXXXXXXXXXXXXXX------