----------------------------------------------------------------------------------------------------
----------------------------------------------------------------------------------------------------
-----------------------------------------------------------------------------------?----------------
----------------------------------------------------------------------------------------------------
----------------------------------------------------------------------------------------------------
----------------------------------------------------------------------------------S-----------------
-------------------------------------------------------xx-------------------------------------------
---------xxxxxx---------------------------------------xx-x------------------------------------------
-----xxxxx--<>-x-------------------------------------xx---x----xx-----------xxxxxxxxxx--------------
---xxx--<>--[]--x-------------------------------xxxxxx-----x--xx-x-xxxxx---xx-XXXXXXX-x----xxxx-----
--xx<>--[]--[]---x------------------------Q----xx---x-------xxx---xx----x-xx-----------x--xx---xxxxx
-xx-[]--[]--[]----x--------------------QQQX---xx----X--------x----<>-----xx-------------xxx----XXXX-
xx--[]--[]--[]-----xxxxxxxxxxxxxxxxxxxxxxxxxxxxX----XX------<>----[]-----<>--------------x----------
XXX-XX--XX--XXXXXXXXXXXXXXXXXXXXXXXXXXXXXXXXXXXX----XXX-----[]----[]-----[]------------XXX----------