----------------------------------------------------------------------------------------------------
--------------------------------------------------xx------------------------------------------------
------x----XXX-------------------SSSSSSS---------xx-x-----------------------------------------------
-------x---[]---------xxxxx----------------xxxxxxx---x--xxx-----------------------------------------
--------x--[]-------xxx----x--------------xx----x-----xxx--x----------------------------------------
-----------<>------xx<>-----x------------xxX---XX-----XXX---x---------------------------------------
------------------xxX[]------x----------xx-------------------x--------------------------------------
------------E-----xXX[]-------x--------xx----ooooooo----------x-------------------------------------
----------------xxxXX[]--------x--xxxxxx-----ooooooo-----------x-----------------------------S------
x----------xxx-xx<>XX[]---------xxxXXXXX-----------E------------x-----------------------------------
-xx-------xx--xxX[]XX[]----------x----------------<>-------------x-----------------xxxx-----xxx----x
<>-x-----xx--<>XX[]XX[]----------SS----------E----[]--------------x---------------xx<>-x---xxS-x--xx
[]--xxxxxx---[]XX[]XX[]--------X-SS---------<>----[]--------------Xxxxxxxxxxxxxxxxx-[]--xxxx-S--xxx-
XXXXXXXXXX---[]XXXXXXXXXXXXXXXXXXXX---------[]----[]-------------XXXXXXXXXXXXXXXXXXXXXXXX<>XXXXXXXXX