----------------------------------------------------------------------------------------------------
----------------------------------------------------------------------------------------------------
----------------------------------------------------------------------------------------------------
----------------------------------------------------------------------------------------------------
--------------------xxxxxxxxxxx----------E-E------------------xxxxx---------------------------------
--------Q?---------xx--QQQ?QQQ-x-------SSSSSSS-SS-xxxx-----xxxx--X-x--------------------------------
------------------xx------------x-------------E--xx---x---xx--E--X--x-------------------------------
-----------------xx------E-------x--------------xx-----x-xx---XX-X---x------------------------------
xx------SS-----xxx-----SSSSSSS----x-----------xxx-------xx----XX-X----x-------------xxx----------E--
x-x----xxx----xx<>--------------E--x---------xx<>-------<>----XX-X-----x-----------xx--x--------<>--
>--x--xx--x--xx-[]-------X------X---x---E---xx-[]-------[]----XX-X------x---------xx----x-----------
]---xxx----xxx--[]-------X------X----x-----xx--[]-------[]----XX-X-------S-----S-xx-----------------
]----x------x---[]----E--X------X-----xxxxxx---[]-------[]----XX-X-------xxxxxxxxx------Xxxxxxxxxxxx
X----X------XXXXXXXXXXXXXXXXXXXXXXXXXXXXXXXXXXXXX-------XX-XXXXX-XXXXXXXXXXXXXXXXX------XXXXXXXXXXXX