----------------------------------------------------------------------------------------------------
----------------------------------------------------------------------------------------------------
SSSSSSSSSSSSSSSSSSSSSSSSSSSSSSSSSSSSSSSSSSSSSSSSSSSSSSSSS?SSSSSSSSSSSSSSSSSSSSSSSSSSSSSSSSSSSSSSSSSS
-----------SSSSSSS----------------------------------------------------------------------------------
-----------SSSSSSS----------------------------------------------------------------------------------
-----------SSSSSSS-------ooooo----------------------oooooo------------------------------------------
--------------------------------------------------------------------------xx------------------------
------------------------SSSSSS-S--------------------SSSSSS---------------xx-x-xxx-------------------
--xxxxxxxxxxxxxxxxx-----SSS--SoS--------------------SSSSSS--------------xx---xx--x------------------
xxxS???????SSSSSSS-x----SSS--SSS---------------xxx--------------------xxx----<>---x------xxxx-------
SSSSSSSSSSS---------x--------------------E----xxS-x------------------xx<>----[]----xxx--xxSS-x------
SSSSSSSSSSS----------x------------------<>---xx-S--x----------------xx-[]----[]----<>-xxx-SS--x-----
SSS-SSSSSSS-----------xxxxxxxxxxxxxxxxxxxxxxxx--S---xxxxxxxxxxxxxxxxx--[]----[]--E-[]--x--SS---xxxxx
XXXXXXXXXXXXXXXXXXXXXXXXXXXXXXXXXXXXXXXXXXXXXX--X--XXXXXXXXXXXXXXXXXXXXXXXXXXXXXXXXXXXXX--XX--XXXXXX