--------------------------------------------------
--------------------------------------------------
--------------------------------------------------
--------------------------------------------------
---------------------------xxxxxxx----------------
xx------------------------xx--QQQ-xx--------------
--x----------------------xx-------X-x-------------
---x--------------------xx------EXX--x------------
----x-----------------xxx-----SSSSS---x----------x
-----x--------------xxx<>--------XX----x--------xx
-E----xxx----------xx<>[]-------XXX-----x------xx-
<>----<>-x------B-xx-[][]-------XXX------x----xx--
[]----[]--xxxxxxxxx--[][]----E--XXX-------xxxxx---
XXXXXXXXXXXXXXXXXXXXXXXXXXXXXXXXXXXXXXXXXXXXXXXXXX