----------------------------------------------------------------------------------------------------
----------------------------------------------------------------------------------------------------
--[]SSSSSSSS-----------------------------------------------------o-o---------------------SSSSSSSSSSS
--[]SSSSSSSS---------------------xxx--------------------------------------xxx--------------[]----[]-
--[]SSSSSSSS----------xxxxx----xxx--x-----------------------------------xxx--x-------------[]----[]-
--[]SSSSSSSS-------xxxx----x--xxXS---x---------------------------XX----xx-X---x------------[]----[]-
--[]SSSSSSSS------xx-<>-----xxxEX-----x-------------------------------xx-------x-----------<>----[]-
--[]SSSSSSSS-----xx--[]------xXXX------x-----------------------------xx---------x----------------[]-
---]SSSSSSSS---xxx---[]------XXXXS------x-------------------------xxxx-----------x---------------[]-
xx-]SSSSSSSS--xx<>---XX-----XXXXX--------x--------------XXXX-----xxXXX------------x--------------[]-
SSSSSSSSSSSS-xx-[]---------XXXXXX---------x---------------------xx-----------------x-------------<>x
SSSSSSSSSSSSxx--[]--------XXXXXXX----------x-----xxxx---xxx----xx-------------------x-----xxx-----xx
SXXXXSSSSSSSx---[]--------XXXXXXX---------X-xxxxxx---xxxx--xxxxx-------------------X-xxxxxx--xxxxxx-
XXXXXXXXXXXXXXXXXXXXXXXXXXXXXXXXXXXXXXXXX-XXXXXXXX---XXXX--XXXXX-------XXXXXX------XXXXXXXX--XXXXXXE