----------------------------------------------------------------------------------------------------
----------------------------------------------------------------------------------------------------
SSSSSSSSSSSSSSSSSSSSSSSSSSSSSSSSSSSSSSSSS[]SSSSSSSSSSSSSSSSS?SSSSSSSSSSSSSSSSSSSSSSSSSSSSSSSSSSSSSSS
[-----------------------------------SS---[]----SSSS-------------------------------------------------
[--------E--------------------------SS---SS----SSSS-------------------------------------------------
[E---QQQQQQ--------xxxxxxxxx-------x-------------------oooooo---------------------------------------
[>----------------xxSSSSSSS--------S-------------------------------------------xx-------------------
[]---------------xx-SSSSSSS--------S-------------------SSSSSS-----------------xx-x-xxx--------------
[]--xxxxxxxxxxxxxx--SSSSSSS----o??-S------------E------SSSSS-----------------xx---xx--x-------------
[]-xxSSSSSSSSSSSSS--SSSSSSx----SS--SSS---------SSSS------------------------xxx----<>---x------xxxx--
<]xx-SSSSSSSSSSSSS---------x-----------------E-E--------------------------xx<>----[]----xxx--xxSS-x-
x]x--SSSSSSSSSSSSS----------x-------E-------------xxxxx------------------xx-[]----[]----<>-xxx-SS--x
x]---SSSSSSSSSSSSS-----------xxxxxxxxxxxxxxxxxxxxxx----xxxxxxxxxxxxxxxxxxx--[]----[]--E-[]--x--SS---
XXX--XXXXXXXXXXXXXXXXXXXXXXXXXXXXXXXXXXXXXXXXXXXXXX---XXXXXXXXXXXXXXXXXXXXXXXXXXXXXXXXXXXXXXX--XX--X