----------------------------------------------------------------------------------------------------
----------------------------------------------------------------------xxx---------------------------
---------------------------------------------------------------------xx--xxxx-----------------------
-------------------------------------------------------------xxxxx--xx----x--x----------------------
------------------------------------------------------------xx----xxx-----X---x---------------------
------XX------------------------QQQ?QQQQQQQQQ?QQQQ---------xxX-----x-----------x--------------------
------[]---------------------------------------[]---------xxXX----XX------------x-------------------
------[]---------------------------------------[]--------xxXXXXX-----------------x------------------
------[]---------------------------------------[]-------xxXXXX--------------------x-------------S---
xx----<>SSSSSS--------------------SSSSSSSSSSSS-<>------xxXXXXX---------------------x----------------
X-x---------------------------------------------------xxXXXXXX----------------------x----------xxx--
XX-x---Exxx----------------------E---E-------S-xxx---xxXXXXXXX-E---------------------xx-------xxS-x-
XXXXxxxxxE-xxxxxxxxxxxxxxxxxxxxxxxxxxxxxxxxxxxxxE-xxxxXXXXXXXX<>--------------------XX-xxxxxxxx-S--x
XXXXXXXX<>XXXXXXXXXXXXXXXXXXXXXXXXXXXXXXXXXXXXX<>-XXXXXXXXXXXX[]--------------------XXXXXXXXX>XXXXXX