----------------------------------------------------------------------------------------------------
----------------------------------------------------------------------------------------------------
----------------------------------------------------------------------------------------------------
----------------------------------------------------------------------------------------------------
--------------------------------------B---------------------------------------------------xxxxx-----
--------------------------------------b----------------------------------------------E-xxxx--X-x----
--------ES--------------E-------------------------------------------------------------xx--E--X--x---
-S------------QQQ------<>------------------------------------------------------------xx---XX-X---x--
-----------------------[]----------------------------------------------------------xxx----XX-X----x-
--------------------QQQQQQQQQQQ---------------------------------------------------xx<>----XX-X-----x
--xxx---------------------------------------E---B----?QQ-------------------------xx-[]----XX-X------
-xxB-x----------xxxxx---------------------------b-----------------xxx------xxxx-xx--[]----XX-X------
xx-b--xxxxxxxxxxxB---xxxxxxxxxxxxxxxxxxxxxxxxxxxxxxxxxxxxxxxxxxxxxx--xxxxxxx---xx---[]----XX-X------
XXXXXXXXXXXXXXXXXX--XXXXXEEXXXXXXXXXXXXXXXXXXXXXXXXXXXXXXXXXXXXXXXX--XXXXXXX--XXXXXXXXXXXXXX-XXXXXXX