----------------------------------------------------------------------------------------------------
----------------------------------------------------------------------------------------------------
-----------------------------------------------------------SSSSSSSSSSSSSSSSSSSSSSSSSSSSSSSSSSSSSSSS-
----------------------------------------------------------------------------------------------------
-------------------------xxx------------------------------------------------------------------------
S-----------------------xx--x------------------------------------------------------xxxxxx-----------
-----------------------xxX---x----------------------------------------------------xxSSSS-x----------
----------------------xxXX----x-----xxx------------------------------------------xx-S-----x-x-------
x--------------------xxXXX-----xxxxxx--x-------------------------------------xxxxx--S------xx-------
-xx---SSQS--------xxxxXXXX------xXXXX---x------------------------QQQQQ-----xxxXXXX------E--<>--xxxxx
<>-x------------xxx--XXXXX-----XXXXXX----x-------------------------------xxxXXXXXXXX---<>--[]xxxSSSS
[]--x----------xx<>-XXXXXX----XXXXXXX-----xx-----------xxx-------------xxxXXXXXXXXXX---[]--[]xS-SSSS
[]---xxxxxxxxxxx-[]XXXXXXX---XXXXXXXX-----X-xxxxxxxxxxxx--xxxxxxxxxxxxxxXXXXXXXXXXXXE--[]--[]-S-SSSS
XXXXXXXXXXXXXXXXXXXXXXXXXXXXXXXXXXXX-----XXXXXXXXXXXXXXX--XXXXXXXXXXXXXXXXXXXXXXXXXXXXXXXXXXXXXXXXXX