----------------------------------------------------------------------------------------------------
----------------------------------------------------------------------------------------------------
----------------------------------------------------------------------------------------------------
----------------------------------------------------------------------------------------------------
----------------------------------------------------------------------------------------------------
---------------------------------SSSSSS--------------xxx------------xx--------------------------SSSS
-------------------------------E--------------------xx--x----------xx-x------------------------S----
--------------------------------xxxxx--------------xx----x--xxxx--xx---xxx--------------------SS----
X-----------------------------xxx----xx----------xxx------xxx---xxx-----x-x------------------SSS----
X----------------------------xx<>---<>-x--------xx<>------XXX---XXX-----S--xS---------------SSSS----
----------------------------xx-[]---[]--x------xx-[]--QQQ-------------------x-----------------------
------xxx------------------xx--[]---[]---x----xx--[]-------------------------x------xxx----xxx------
xxxxxxx-Exxxxxxxxxxxxxxxxxxx---[]---[]----xxxxx---[]--------------------------xxxxxxxE-xxxxxB-xxxxxx
XXXXXXX--XXXXXXXXXXXXXXXXXXXXXXXX---XX--XXXXXXXXXXXXX-------------------------XXXXXX<>XXXXXXXXXXXXXX