----------------------------------------------------------------------------------------------------
----------------------------------------------------------------------------------------------------
----------------------------------------------------------------------------------------------------
----------------------------------------------------------------------------------------------------
----------------------------------------------------------------------------------------------------
E-------------------------------------------------------------xxx-----------------------------------
>------------------------------------------------------------xxX-x----------------------------------
]-----------------------------------------------------------xxXX--x--------------xxxxx--------------
]-------xxxx----------------------------xx-----------------xxXXX---x----------xxxx-<>-x-------------
]------xx<>-x--------------------xxxx--xx-x---------------xxXXXX----x--------xxQQ?-[]--x------------
>-----xx-[]--x----QQQQQQQQ?-----xx---xxx---x-------------xxXXXXX-----x------xx-----[]---x-----------
xx---xx--[]---x----------------xx-----x-----xx----------xxXXXXXX------x----xx------[]----x----------
B-xxxx---[]----xxxxxxxxxxxxxxxxxX-----X-----X-xxxxxxxxxxxXXXXXXX-------xxxxx--X----[]-----xxxxxxxxxx
XXXXXXXXXXXXXXXXXXXXXXXXXXXXXXXXX-----X-----XXXXXXXXXXXXXXXXXXXXXXXXXXXXXXXXXXXXXXXXXXXXXXXXXXXXXXXX