-------------------xxxx-----------------------------------------------------------------------------
xxxxxxxxxxxxxxxxxxxx---xxxxxxxxxxxxxxxxxxxxxxxxxx---------------------------------------------------
SSSSSSSSSSSSSSSSSSSS---SSSSSSSSSSSSSSSSSSSSSSSSSS---------------------------------------------------
SSS--------------------SSSS-------------------------------------------------------------------------
SSS--------------------SSSS------------------------------------------------------------------------E
SSS--------------------SSSS----E---------------------------------------------------------------SSSSS
------------------------------<>--------------------------------------------------------------------
------------------------------[]--------------------------------------------------------------------
-------------XXX---------E----[]----------------------------------------------------------------E---
E-----------------------<>---?SSS--E-------E--------------------xxx--------------------xxxx---SSSSSS
oo----XX----------------[]--------<>------->---SS--------------xxX-x------------------xx<>-x--------
-----XXX----------------[]--------[]---<>--]---SS-----------B-xx-X--x--------------B-xx-[]--x-------
EE--XXXX----------------[]--------[]---[]--]---SSxxxxxxxxxxxxxx--X---xxxxxxxxxxxxxxxxx--[]---xxxxxxx
XXXXXXX-------------XXXXXXXXX----XXX---XX--X---XXXXXXXXXXXXXXXXXXXXXXXXXXXXXXXXXXXXXXXXXXXXXXXXXXXXX