----------------------------------------------------------------------------------------------------
----------------------------------------------------------------------------------------------------
----------------------------------------------------------------------------------------------------
----------------------------------------------------------------------------------------------------
------------------------------------------------------------------------------xxxxxxxxxxxxx---------
------------------x------------------------E--S---SSSSSSSSS-x----------------xx--QQQ?QQQQQ-x--------
-------------------x--------xxxx----------<>--------------------------------xx--------------x-------
--------------------x------xx---x---------[]-------------------------------xx------E---------x------
---xx----------------x-xxxxx-----xxx------[]------------xxxx-------------xxx-----SSSSSSESS----x-----
--xx-x--------------E-xx--<>-----<>-x----SXXS----------xx--xxx----------xx<>----------<>-------x----
x-x---x------------<>-<>--[]-----[]--xx------xxxx-----xx------xx-------xx-[]-------X--[]--------x---
x-----X------------[]-[]--[]-----[]-<>-x----xx<>-x---xx---------x-----xxXX[]-------X--[]---------x--
Xx----Xxxxxxxxxxxxx[]-[]--[]-----[]-[]--xxxxx-[]--xxxx--------X--xxxxxx---[]----E--X--[]----------xx
X-----XXXXXXXXXXXXXXXXXXXXXXXXXXXXXXXXXXXXXXXXXXXXXXXX------XXXXXXXXXXXXXXXXXXXXXXXXXXXXXXXXXXXXX-XX