----------------------------------------------------------------------------------------------------
----------------------------------------------------------------------------------------------------
-------------------------------------------x--------------------------------------------------------
---------------------------xxx--------------x-------------------------------------------------------
-------xxx-------xxxx----xxx--x--------------x------------------------------------------------------
------xx--x-----xx---x--xxXS---x--------------xx-------S------------------------------------------E-
-----xx----x---xx-----xxxEX-----x---------------x--------------------------------------------------x
----xx------x-xx-------xXXX------x---------------xxxx--xxxx---------------------------------------xx
--xxx--------xx--------XXXXS------x---------------xB-xxx---x-------E----------------------------xxxX
-xx<>--Q-----<>-------XXXXX--------x--------------XXXXES----x-----<>------------------xx-------xx<>X
xx-[]--------[]------XXXXXX---------x------------XXXXXX------x-----------------------<>-x-----xx-[]X
x--[]--------[]-----XXXXXXX----------x----------XXXXXXX-------x---------xxxxx---------]--x---xx-X[]X
]--[]--------[]----XXXXXXXX---------X-xxxxxxxxxXXXXXXXX-------Xxxxxxxxxxx----xxxxxxxxx]---xxxx-XX[]X
XXXXXXX-XXXXXXXXXXXXXXXXXXXXXXXXXXX-XXXXXXXXXXXXXXXXXXXXXXEXXXXXXXXXXXXXX---XXXXXXXXXXXXXXXXXXXXXXXX