--------------------------------------------------
--------------------------------------------------
--------------------------------------------------
--------------------------------------------------
-xxxxxxxxxxxxxxx--------------------xxxxxxxxxxx---
xx---QQQQ?QQQ?Q-x------------------xx--QQQ?QQQ-x--
x----------------x----------------xx------------x-
x-----------------x--------------xx------E-E-----x
B----SSS-S---S-----x-----------xxx-----SSSSSSS----
--E-----E---E-------x---------xx<>---------X------
-<>----<>--<>--------x-------xx-[]-------X-X------
-[]----[]--[]---------x-----xx--[]-------X-X------
-[]-E--[]--[]----------xxxxxx---[]----E--X-X------
XXXXXXXXXXXXXXXXXX--XXXXXXXXXXXXXXXXXXXXXXXXXXXXXX