----------------------------------------------------------------------------------------------------
-------------------------------------------------xxx------------------------------------------------
------------------------------------------------xx--x---------------SSSSSSSSSSSSSSSSSSS-SSSSSSSSSSSS
-----------------------------------------------xx----x----------------[]----[]----------------------
-----------------------------------------------xS-----xxxx------------[]----[]-------E--------------
----xxxxx--------------------------------------x-------x--x-----------[]----[]---QQQQQQ-------xxxxxx
---xxXXX-x------------------------------------xx-------X---x----------<>----[]---------------xxSSSSS
--xxXXXX--x----------------xxxxx-------------xxS------XX----x---------------[]--------------xx-SSSSS
xxxXXXXS---x-------------xxx--S-x------o---xxx-------XXX-----x--------------[]--xxxxxxxxxxxxx--SSSSS
-xXXXXXX----x-----------xx<>-----xx-------xx<>------XXXX------x-------------[]-xxSSSSSSSSSSSS--SSSSS
XXXXXXXX-----x----E----xx-[]----<>-x-----xx-[]-----XXXXX-------x------------<>xx-SSSSSSSSSSSS------S
XXXXXXXX------x-------xx--[]----[]--x---xx--[]----XXXXXX--------x----xxx-----xx--SSSSSSSSSSSS-------
XXXXXXXX-------xxxxxxxx---[]----[]---xxxx---[]---XXXXXXX-------X-xxxxx--xxxxxx---SSSSSSSSSSSS-------
XXXXXXXXXXXXXXXXXXXXXXXXXXXXXXXXXXXXXXXXXXXXXXXXXXXXXXXXXXXXXXXXXXXXXX--XXXXXXE--XXXXXXXXXXXXXXXXXXX