----------------------------------------------------------------------------------------------------
----------------------------------------------------------------------------------------------------
----------------------------------------------------------------------------------------------------
----------------------------------------------------------------------------------------------------
----------------------------------------------------------------------------------------------------
-------------------------------------E-------------SSSSSSSSSSSSSS----------------------------SSSSS--
-----xx--------------ES-------------<>--------------[]----------------------------------------------
----xB-x------S------------QQQ------[]--------------[]------------------------SS--------------------
xxxxxb------------------------------[]--------------[]--------xxxx---------oooS---------------------
x--XXXX-xS-----------------------QQQQQQQQQQ---------[]-------xx--xxx----------S----------S----E-----
>--XXXX--x-----xxx----------------------------------<>------xx------x------------------------------E
]--XXXX---x---xxB-x----------xxxxx------------------xxx----xx--------xx-----------------------------
X--XXXX----xxxx-b--xxxxxxxxxxxB---xxxxxxxxxxxxxxxxxxxE-xxxxx--------XX-xxxxxxxxxxxxxxxxxxxxxxxxxxxxx
X-EXXXXXXXXXXXXXXXXXXXXXXXXXXXX--XXXXXEEXXXXXXXXXXXXXXXXXXXX------XXXXXXXXXXXXXXXXEEXXXXXXXXXXXXXXXX