----------------------------------------------------------------------------------------------------
----------------------------------------------------------------------------------------------------
----------------------------------------------------------------------------------------------------
------------------------------------------o---------------------------------------------------------
-------xxxxxxxxxxx-----------------------XXX--------------------------------------------------------
------xx---x---XX-x------------SSSS----------o------o-o---------------------------------------------
-----xx-E--E---[]--x------------[]-----------XXXX---------------------------------------------------
---xxx---------[]---x-----------[]-----------------xxxxxx-------------------------------------------
--xx-E---------[]----x----------[]----------------xxXXXX-x---------xxxx----------------B------------
-xx------------[]-----xx--------[]------------xx-xx-------x-------xx<>-x---------------b------------
xx-------------<>-----B-x-------<>-----------xx-xx---------x-----xx-[]--x----QQQQQ?-B------?QQ------
x---------------------b--x------xxx---X-----xx--XXXX--------x---xx--[]---x----------b---------------
X---------------E-----B---xxxxxxxE-xxxxxxxxxx----------------xxxx---[]----xxxxxxxxxxxxxxxxxxxxxxxxxx
X-------------XXXXXXXXXXXXXXXXXXXXXXXXEXXXXXX------------XXXXXXXXXXXXXXXXXXXXXXXXXXXXXXXXXXXXXXXXXXX