----------------------------------------------------------------------------------------------------
----------------------------------------------------------------------------------------------------
----------------------------------------------------------------------------------------------------
----------------------------------------------------------------------------------------------------
----------------------------------------------------------xxxxxxxxxx--------------------------------
------QQQQQ-----------------------------------------------xSSSSSSSS-x-------------------------------
----------------------------------------------------------x----------x------------------------------
----------------------------------------------------------x-----------x-----------------------------
---------------------------------------------------------xx------------x------------------o-------xx
-----E?QQQQ-----------E----------------------xxxx-------xxX----S----X---x------------------------xx<
xx-------------------<>---------------------xx<>-x-----xx-X------E--X----x--E-------------------xx-[
>-x------------------[]--------------------xx-[]--x---xx--X---------X-----xxxxxxxxxxx----------xx--[
]--xxxxxxxxxxxxxxxxxx[]--------Exxxxxxxxxxxx--[]---xxxxE--X---------X------x----x----xxxxxxxxxxx---[
XXXXXXXXXXXXXXXXXXXXXXXXXXXXXXXXXXXXXXXXXXXXXXXXXXXXXXXXXXXXXXXXXXXXXXXXXX-X-XX-X-XX-XXXXXXXXXXXXXXX