-------------------------------------------------------------------------------xxx-------xxx--------
-------------------------------------------------------------------------xxxxxxx--x-----xx--x-------
-------------------------------------------------------------------------xx---x----x---xx----x-----x
------------------------------------------------------------------------xx---<>-----x-xx------x---xx
----------------xxx--------oo------------------------------------------xx----[]------xx---------xxx-
---------------xx--x---------------------------------------------------xS----XX------XX--------x-x--
--------------xx----x--------------------------------------------------x-----------------------S<>--
-------------xx------x-------------------------------------------------x-------------------oo--S[]--
x------o---xxx--o-----xxx---------------------------------------------xx-------------------SS---[]--
-xx-------xx<>--------<>-x-------------------------------xxxx--------xxX----------------------------
<>-x-----xx-[]--------[]--x-----xxxx--------------------xx<>-x------xx-X----------------------------
[]--x---xx--[]--------[]---x---xx<>-x------------------xx-[]--x----xx--X-----------ooooo------------
b]---xxxx---[]--------[]-E-Exxxx-[]-Exxxxxxxxxxxxxxxxxxx--[]---xxxxxE--X-----------ooooo-------->---
XXXXXXXXXXXXXXXXXXXXXXXXXXXXXXXXXXXXXXXXXXXXXXXXXXXXXXXXXXXXXXXXXXXXXXXXXX---------XXXXX--------]---