----------------------------------------------------------------------------------------------------
--------------------------------------------xx------------------------------------------------------
SSSSSSSSSSSSSSSSSSSSSSSSSSSSSSSSS----------xx-x-----------------------------------------------------
SS-----------SSSSSSSSSSS------------------xx---x----------------------------------------------------
SS--xx-------SSSSSSSSSSS----------------xxx-----x---------------------------------------------------
SS-xx-x------SSSSSSSSSSS--QQ------xxxxxxx--------x-------------------------------------------------S
--xx---xxxxx---------------------xxS-SSSS---------x-------------------------------------------------
-xx---SSSSS-x----------xxx-xxx--xx-S---------------x------------------------------------------------
xx----SSSSS?-xxxxxxxxxxx--xx--xxx--S----------------xxxxx-----------------X-------------------------
SS----SSSSS??SSSSSSSSSSS--QQ--QQQ--S-----------------xXX-x----------------X-------------------------
SS---------------------------------S-----<>---------XXXX--x----E----------X-------------------------
SS-------------------Q-------------------[]--------XXXXX---x-----------xxxxx-------------xxxx-------
SS---------------------------------------[]-------XXXXXX----xxxxxxxxxxxxE-E-xxxxxxxxxxxxxxEE-xxxxxxx
XXXXXXXXXXXXXXXXXXXXXXXXXXXXXXXX----XXXXXXXXXXXXXXXXXXXXXXXXXXXXXXXXXXXXXXXXXXXXXXXXXXXXXXXXXXXXXXXX