----------------------------------------------------------------------------------------------------
----------------------------------------------------------------------------------------------------
----------------------------------------------------------------------------------------------------
----------------------------------------------------------------------------------------------------
-------------------------------------------------------------------------------------------E--------
------------------------------------SSSSSSSS--------------E------E-------------------------S--------
-------------------------------------------------------E--------------------------------------------
---------------------------------------------------xxxxxxxxxxxxxxx-------------------------?--------
------B------------------------------E--Eoo-------xxXSSSSSSSSSSSS-x--------------xxxx---------------
------b-----------------------------SSSSSSSS-----xxXX--------------x---------QQ-xx-X-x----xxx-------
QQ?B----------------------Q?QQQQ----------------xxXXX----oooooo-----x----------xx--X--x--xxX-x------
---b------xxxx-------------------------xxxx----xxXXXX----------------xxxx-----xx---X---xxx-X--x----x
xxxxxxxxxxx---xxxxxxxxxxxxxxxxxxxxxxxxxx---xxxxxXXXXX----oooooo-------x--xxxxxx----X----x--X---xxxxx
XXXXXXXXXXX---XXXXXXXXXXXXXXXXXXXXXXXXXX---XXXXXXXXXXXXXXXXXXXXXX-----X--XXXXXX--XXXXXXXXXXXX-XXXXXX