----------------------------------------------------------------------------------------------------
----------------------------------------------------------------------------------------------------
--------------------------------------------------------------------------------------xxxx----------
-------------------------------------------------------------------------------------xx<>-x---------
-------------------------------------------------------------------------------------x-[]--xxxxxx---
---xxxxxx-----------------XX------------------------QQQ?QQQQQQQQ?QQQQQ------------SS-xX[]---x----x--
--xx-XXX-x----------------[]--------------------------------------[]----------------xx-----XX-----x-
-xxX-XXX--x-------x-------[]--------------------------------------[]---------------xxS-------------x
xxXX-XXX---x-----xxx------[]--------------------------------------[]-------------xxxS---------------
xXXX-XXX----x---xx-xx-----<>SSSSSS--------------------SSSSSSSSSSS-<>------------xx<>----------------
XXXX-XXX-----x-xx----x-----------------------------------------------SSS-------xx-[]----------------
XXXX-XXX------xx------xx---Exxx----------------------E---E--------xxxSSSx-----xx--[]----------------
XXXX-XXX------XX-----XX-xxxxxE-xxxxxxxxxxxxxxxxxxxxxxxxxxxxxxxxxxxxE-SSS-xxxxxx---[]---------------X
XXX--XXXXXXXXXXX-----XXXXXXX<>XXXXXXXXXXXXXXXXXXXXXXXXXXXXXXXXXXXX<>-XXXXXXXXXXXXXXXXXX------------X