xx----------------xxxxxxxxxx------------------------------------------------------------------------
--xxxxxxxxxxxxxxxxx--XX-X---xxxxxxxxxxxxxxxxxxxxxxxxxxxx--x-----------------------------------------
[]SSSSSSSSSSSSSSSSS---------SSSSSSSSSSSSSSSSSSSSSSSSSSS-x-S-----------------------------------------
[]--------------------------SSSS-------------------------x-x----------------------------------------
[]--------------------------SSSS----------------------------x---------------------------------------
[]-SSS----------------------SSSS----E------------------------x--------------------------------------
[]---------------------------------<>-------------------------x-----------------------------------xx
]]---------------------------------[]--------E-----------------x---------------------------------xx-
-----------XXX----------------E----[]-------<>----------------E-x------------------------------xxx--
-----------------------------<>---?SSS------[]------------E--<>--xxx--------------------------xx<>--
S---<>-----------------------[]--------<>---[]--<>-------<>--[]--<>-x----------------E-------xx-[]--
S---[]-------------XXXXXX----[]--------[]---[]--[]---<>--[]--[]--[]--x----------------------xx--[]--
S---[]------------XX---------[]--------[]---[]--[]---[]--[]--[]--[]---xxxxxxxxxxxxxxxxxxxxxxx---[]Q?
X---XX----------------X-X-XXXXXXXX----XXX---XX--XX--XXXXXXXXXXXXXXXXXXXXXXXXXXXXXXXXXXXXXXXXXXXXXXXX