----------------------------------------------------------------------------------------------------
----------------------------------------------------------------------------------------------------
------------------------------------------------ESSS------------------------------------------------
-------------------xxx-------------------------------------------------------------------xxx--------
---------xxxx----xxx--x----------------------------------------------------------------xxx--x-------
--------xx---x--xxXS---x----------------------------------------E---------------------xxXX---x------
-------xx-----xxxEX-----x-------------------------------------------------<----------xxXXX----x-----
------xx-------xXXX------x--------------------------------------xxxxx----x[xxx------xxXXXX-----x----
-xxxxxx--------XXXXS------x-------------------xxxxxx----------xxx----x-xxx[--------xxXXXXX------x---
xx---<>-------XXXXX--------x-----------------xx-XXX-x--------xx<>-----xx<>[---x---xxXXXXXX-------x--
<>---[]------XXXXXX---------x--------S------xx-------x------xx-[]----E<>[]]----x-xxXXXXXXX--------x-
[]---[]-----XXXXXXX----------x-------B-----xx---------x----xx--[]---<>[][]]-----xxXXXXXXXX---------x
QQX--[]----XXXXXXXX---------X-xxxxxxxxxxxxxx-----------xxxxx---[]---[][][]]-----XXXXXXXXXX--------X-
XXXXXXXXXXXXXXXXXXXXXXXXXXX-XXXXXXXXXXXXXXXX-----------XXXXXXXXXXXXXXXXXXXXXXXXXXXXXXXXXXXXXXXXXXXXX