----------------------------------------------------------------------------------------------------
----------------------------------------------------------------------------------------------------
----------------------------------------------------------------------------------------------------
----------------------------------------------------------------------------------------------------
----------------------------------------------------------------------------------------------------
--------E--S---SSSSSSSSS------------S-ESSS--------SSSSSSSSS------------SS---SS-------------SSS----XX
-------<>----------------------------<>-------------------------------------------------------------
-------[]----------------------------[]-------------------------------------------------------------
-------[]------------xxxx------------[]---xxxx----------xxxx---------SS--------------xxxxx----------
------SXXS----------xx--xxx-xxx---SSSQQ--xx<>-x--------xx--xxx-xxx---------SSS---xxxxx-XX-xSSS------
xx--------xxxx-----xx------xx--xxx------xx-[]--x------xx------xx--xxx-----------xxXX<>-XX--x--------
>-xx-----xx<>-x---xx-------<>--<>-x----xx--[]---x----xx-------<>--<>-x-xxxxx---xxXXX[]-XXX--x-------
]XS-xxxxxx-[]--xxxx--------[]--[]--xxxxx---[]----xxxxx--------[]--[]--xx----xxxxXXXX[]-XXX---xxxxxxx
XXXXXXXXXXXXXXXXXXX------XXXXXXXXXXXXXXXXXXXXXXXXXXXXX------XXXXXXXXXXXX-X-XXXXXXXX-XXXXXXXXXXXXXXXX