----------------------------------------------------------------------------------------------------
----------------------------------------------------------------------------------------------------
----------------------------------------------------------------------------------------------------
----------------------------------------------------------------------------------------------------
----------------------------------------------------------------------------------------------------
SS----------------------xxx----------------------------------SSS---?-------xx-----------------------
oo---------------------xx--x----------------------------------------------xx-x----------------------
----------------------xx----x--------------------------------------------xx---x---------------------
--------------------xxx------xxx-------xxxx----S------------------------xx-----xxx-------xxxx----S--
QQQQQ--S----------xxxSS------<>-x-----xx<>-x--------------------------xxx------<>-x-----xx<>-x------
b-------xxxx-----xx<>--------[]--x---xx-[]--x--------------------E---xx<>------[]--x---xx-[]--x-----
x------xx<>-x---xx-[]--------[]---x-xx--[]---x------xxxx------------xx-[]------[]---x-xx--[]---x----
-xxxxxxx-[]--xxxx--[]--E-----[]----xx-E-[]----xxxxxxx---xxxxxxxxxxxxx--[]-E----[]----xx-E-[]----xxxx
XXXXXXXXXXXXXXXXXXXXXXXXXXXXXXXXXXXXXXXXXXXXXXXXXXXXX---XXXXXXXXXXXXXXXXXXXXXXXXXXXXXXXXXXXXXXXXXXXX