----------------------------------------------------------------------------------------------------
----------------------------------------------------------xxx---------------------------------------
---------------------------------------------------------xx--x--------------------------------------
--------------------------------------------------------xx----xx------------------------------------
-------------------------------------------------------xx-----E-xxxxxx------------------------------
--oSSS--------SSSSS-------SSSS-----------------------xxx---------x----x-------SSSSSSS----------XXXXX
----------------------------------------------------xx-S--------<>-----x----------------------------
---------------------------------------------------xx-----------[]------xxxx--------xxx-------------
------xxxx--------------------------xxxx----------xx------------[]-------xB-xxxxxxxxx--x------------
-----xx<>-x-QQQQ--QQQQ-------------xx<>-x--------xx-------X-----XX-------XXXXESSSSSSS---x-----------
----xx-[]--x----------------------xx-[]--x------xxE---------------------XXXXXX-----------x----------
---xx--[]---x------------xxxxx---xx--[]---x----xx<>--------------------XXXXXXX------------x--------x
xxxx---[]----xxxxxxxxxxxxx----xxxxE--[]----xxxxx-[]-----X-------------XXXXXXXX-----------B-xxxxxxxxx
XXXXXXXXXXXXXXXXXXXXXXXXXX----XXXXXXXXXX---XXXXXXXXXXXXXX-------------XXXXXXXXXXXXXXXXEXXXXXXXXXXXXX