----------------------------------------------------------------------------------------------------
----------------------------------------------------------------------------------------------------
----------------------------------------------------------------------------------------------------
----------------------------------------------------------------------------------------------------
-----------------------------------------------------------------------------x-----xxxxx------------
---------------------SSSSS---?-------xxx-------xx-------S---E--S-----------xxx-xxxxx----xxxxxxxxxxxx
------------------------------------xx--x-----xx-x---------<>-------------xx-S-SSSSS----SSSSSSSSSSX-
<----------------------------------xx----x---xx---x--------[]------------xx---xx------------------X-
----------------------------------xx------xxxx-----xxx-----[]-----------xx----x-------------------X-
xxx----------xxx--S---E---------xxx------SSSS?-----<>-x----XXS-xxx-----xx----S?S------------------X-
B>-x----------<>-----------E---xx<>----------------[]--x------xxX-x---xxE----SS-------S----------?X-
b]--x-------------------------xx-[]----------S-----[]---x----xx<>--x-xx<>----SS-------------------X-
B]---xxxxxxxxxxxxxxxxxxxxxxxxxx--[]-E--------------[]----xxxxx-[]---xx-[]--------------------->---X-
XXXXXXXXXXXXXXXXXXXXXXXXXXXXXXXXXXXXXXXXXXXXXXX----XXXXXXXXXXXXXXXXXXXXXXXXXXXXXQS------------]---X-