-----------------------------------------------------------<----------------------------------------
-----------------------------------------------------------[--------------x-------------------------
SSSSSSSSSSSSSSSSSSSSSSSSSSSSSSSSSSSSSSSSSSSSSSSSSSSS-----SSSSSSSSSSSSSSSSSSSSSSSSSSSSSSSSSSSSSSSSSS-
---------------------SSSSSSSSSSSSSSSSSSSSS-----------------------SSSSSSSSSSSSSSSSSSSSSSSSS----------
---------------------SSSSSSSSSSSSSSSSSSSSS-----------------------SSSSSSSSSSSSSSSSSSSSSSSSS----------
---------------------SSSSSSSSSSSSSSSSSSSSS--------E--------------SSSSSSSSSSSSSSSSSSSSSSSSS--QQ------
-------------------------------------------------<>------------------------------------------------x
----------------------------xxx------------------[]---------------------xxx--------------xxx-xxx--xx
xx-------------------xx-xxxxx?-xxxxxxxxxxxx------[]----xxx-------xxxxxxxx?-xxxxxxxxxxxxxxx--xx--xxx-
S-x----xxxx---------xx-xSSSSS??SSSSSSSSSSS-x----------xx--x-x---xx-SSSSSS??SSSSSSSSSSSSSSS--QQ--QQQ-
S--x--xxSS-x-------xx--SSSSS---SSSSSSSSSSS--x--------xx----x---xx--SSSSS---SSSSSSSSSSSSSSS----------
S---xxx-SS--x-----xx---SSSSS---SSSSSSSSSSS---x------xx-------xxx---SSSSS---SSSSSSSSSSSSSSS----------
S----x--SS---xxxxxx---------oooSSSSSSSSSSS----xxxxxxx---------x---------oooSSSSSSSSSSSSSSS----------
X--XXX--XX--XXXXXXX---XXXXXXXXXXXXXXXXXXXX---XXXXXXXX-------xXX---XXXXXXXXXXXXXXXXXXXXXXXXXXXXXXXXX-