------------------------------------------xxx---------------------Exxx--------xxx-------------------
-----------------------------------xxx---xx--x------xxx-----------xx--x------xx--x------xxx---------
SSSSSSSSSSSSSSSSSSS-----SSSSSSSS--xx--x-xx----x---Sxx--x---------xx----x-----x----x----xx--x--------
SSSSSSSSSS-------[]--------------xx--X-xx------x--xx----xx------xx------x---xx-----x--xx----x----xxx
SSSSSSSSSS-------[]-------------xx----XX--------xxx-----E-xxxxxxx--------xxxx-------xxx------xxxxx--
SSSSSSSSSS-------[]------xxxxxxxx-------------XXXXX-------XXXXXXX--------XXXX-------XXX------SSSSS--
-----------------[]------xSSSSSSS-X-----------------------------------------------------------------
-----------------[]------xSSSSSSS-------------------------------------------------------------------
x---xxxxxxx------[]---xxxxSSSSSS--------------------------------------------------------------------
-xxxx-<><>-x-----[]--xx--?SSSSS------------------------------------------------------------------ES-
<>XXX-[][]--x----<>-xx--------------------------------------------------------------------------<>--
[]XXX-[][]---x-----xx---------------------------------------------------------------------------[]--
XXXXX-[][]----xxxxxx-----------------------------------------------X-----------XX---------------[]--
XXXXX-XXXXXXEXXXXXXX----XXXXXXXXX--------------------------------------------------------XXXXXXXXXXX