----------------------------------------------------------------------------------------------------
------------------------------------------------------------------------------------xx----------xx--
-----------------------------------------------------------------------------------xx-x--------xx-x-
----------------------------------------------------------------------------------xx---x----xxxx---x
----------------xxxx----xxxx------------------------------xxx--------------xxx---xx-----xxxxxSx-----
SS---SS--------xx---x--xxXx-x----------------------------xx--x------------xx--x-xx------SSSSS-S-----
--------------xx-----xxxEX---x--------------------------xx----x-----------x----xx-------------------
-------------xx-------xXXX----x------xxxxx-------------xx------x-----xxxxxx----<>-------------------
-----------xxx--------XXXXS----x--xxxx----x------o---xxx------S-x-xxxx---x-----[]-------------------
----SSS---xx<>-------XXXXX------xxx-<>-----xx-------xx<>---------xx-<>---SS----XXX----------ES------
xxx------xx-[]------XXXXXX-------<>-[]----<>-x-----xx-[]---------<>-[]---------------------<>-------
X>-xx---xx--[]-----XXXXXXX-------[]-[]----[]--x---xx--[]---------[]-[]------>--------<>----[]----<>-
[]---xxxx---[]----XXXXXXXX-------[]-[]----[]---xxxx---[]----E----[]-[]------]--------[]----[]----[]-
XX--XXXXXXXXXXXXXXXXXXXXXXXXXXXXXXXXXXXXXXXXXXXXXXXXXXXXXXXXXXXXXXXXXXXXXXXXXXXXXXXXXXXXXXXXXXXXXXX-