----------------------------------------------------------------------------------------------------
----------------------------------------------------------------------------------------------------
----------------------------------------------------------------------------------------------------
----------------------------------------------------------------------------------------------------
-----------------------?----------------------------------------------------------------------------
-----------xxxx-------------------------------------------------------------------------------------
----------xx---x-------E----------------------------------------------------------------------------
---xxxx--xx-----x-xxxxxx-----xx-------------oooo----oooo-----------xx------------oooo----oooo-------
--xx---xxx-------xx-----x---xx-x------------oooo----oooo----------xx-x-----------oooo----oooo-------
-xx----XXX-------XX------x-xx---x-----------E-------------xxxxx--xx---x----------E-------------xxxxx
xx------------------------xx-----xxxxxxxxxxxxxxxxxxxxxxxxxx----xxx-----xxxxxxxxxxxxxxxxxxxxxxxxx----
XX-----------XX----------XXX-----XXXEXXXXXXXXXXXXEXXXXXXXXX-----x------XXXEXXXXXXSXXXXEXXXXXXXXX----
X--------------------------------X--------X---------------X-----X------X-------X---------------X----
X--------------------------------X--------X---------------X-----X------X-------X---------------X----