----------------------------------------------------------------------------------------------------
--------------------------xxx-----------------------------------------------------------------------
-------------------------xx--x----------------------------------------------------------------------
------------------------xx----xx--------------------------------------------------------------------
Q----------------------xx-----E-xxxxxx--------------------------------------------------------------
S------S----S--------xxx---------x----x-------SSSSSSS-xx---------------------------SSSSSSS----------
--------------------xx-S--------<>-----x-------------xx-x-------------------------------------------
-------------------xx-----------[]------xxxx--------xx---xxx--------------------------------------xx
------xxxx--------xx------------[]-------xB-xxxxxxxxx-----x-x-------------xxxx------E--E---------xxX
-----xx<>-x------xx-------X-----XX-------XXXXESSSSSSS-----S--xSSS--------xx<>-x---SSSSSSSS------xxXX
----xx-[]--x----xxE---------------------XXXXXX----------------x---------xx-[]--x---------------xxXXX
---xx--[]---x--xx<>--------------------XXXXXXX-----------------x------Exx--[]---x-----xxx-----xxXXXX
xxxx---[]----xxx-[]-----X-------------XXXXXXXX------------------xxxxxxxx---[]----xxxxxx--xxxxxxXXXXX
XXXXXXXXXXXXXXXXXXXXXXXXX-------------XXXXXXXXXXXXXXXX--------XXXXXXXXXXXXXXXXXXXXXXXXX--XXXXXXXXXXX