--------------------------------------------------
--------------------------------------------------
--------------------------------------------------
--------------------------------------------------
------------xxx-----------------------------------
-----------xx--x---------xx-----------------------
xxxxx-----xx----x-------xx-x----------------------
x----xxxxxx------x-----xx---xxx-------------------
------x--<>-------xxxxxx----<>-x------------------
-----<>--[]------SSSSSS?----[]--x-----------------
-x---[]--[]-----------------[]---x----------------
<>---[]--[]------------S----[]----x---------------
[]---[]--[]-----------------[]-----xxxxxxxxxxxxxxx
XX---XX--XX-XXXX--XXXXXXX---XXXXXXXXXXXXXXXXXXXXXX