----------------------------------------------------------------------------------------------------
----------------------------------------------------------------------------------------------------
----------------------------------------------------------------------------------------------------
----------------------------------------------------------------------------------------------------
-------xxxxx-------------------------xxxxxxxxxxx----------E-E------------------xxxxx----------------
------xxXXX-x-----------------------xx--QQQ?QQQ-x-------SSSSSSS-SS-xxxx-----xxxx--X-x---------------
-----xx-XXX--x---------------------xx------------x-------------E--xx---x---xx--E--X--x--------------
----xx--XXX---x-------------------xx------E-------x--------------xx-----x-xx---XX-X---x-------------
---xxXX-XXX----x----------------xxx-----SSSSSSS----x-----------xxx-------xx----XX-X----x----------xx
--xxXXX-XXX-----x-------SSS----xx<>--------------E--x---------xx<>-------<>----XX-X-----x--------xx<
-xxXXXX-XXX------x------------xx-[]-------X------X---x---E---xx-[]-------[]----XX-X------x------xx-[
xxXXXXX-XXX-------xxx--------xx--[]-------X------X----x-----xx--[]-------[]----XX-X-------x----xx--[
xXXXXXX-XXX-------XX-xxxxxxxxx---[]----E--X------X-----xxxxxx---[]-------[]----XX-X--------xxxxx--X[
XXXXXX--XXXXXXXXXXXXXXXXXXXXXXXXXXXXXXXXXXXXXXXXXXXXXXXXXXXXXXXXXX-------XX-XXXXX-XXXXXXXXXXXXXXXXXX