----------------------------------------------------------------------------------------------------
----------------------------------------------------------------------------------------------------
----------------------------------------------------------------------------------------------------
----------------------------------------------------------------------------------------------------
----------------------------------------------------------------------------------------------------
----------------------------------------------------------------------------------------------------
----------------------------------------------------------------------------------------------------
----------------------------------------------------------------------------------------------------
o------o----o-------------------oo---oo-------------------------------------------------------------
-------------------xxxxx-------xx-------------------------------------------------------------------
------------------xx----x-----xx-x---------------------B----?QQ-------------------------------------
x----xxxxxxxxxx--xxX---X-x---xx---xxxxxx---------------b--------------------xxx-------xxxxx-xxx-----
-xxxxx----x----xxx-X-E-X--xxxx-----x----xxxxxxxxxxxxxxxxxxxxxxxxxxxxxxxxxxxxx--xxxxxxxx----xx--xxxxx
XXXXXX---XX---XXXXXXXXXXXXXXXX-----X----XXXXXXXXXXXXXXXXXXXXXXXXXXXXXXXXXXXXX--XXXXXXXX--X-XX-XXXXXX