----------------------------------------------------------------------------------------------------
----------------------------------------------------------------------------------------------------
----------------------------------------------------------------------------------------------------
----------------------------------------------------------------------------------------------------
----------------------------------------------------------------------------------------------------
----------------------------------------------xxxxx----------------E--------------------------------
----------------------------xxxx-------------xx-<>-x-------------------------------------------xxxxx
---------------------------xxXX-x-----------xx--[]--x--------------xxxx-----------------------xx-XX-
--------------------------xxXXX--xo-------xxx---[]---x------------xx---xxx-------------------xxX-SS-
----xxx------------------xxXXXX---x------xx<>--QQQ?---x----------xx----<>-x-------------xxxxxx-X----
---xxX-x---------------xxxXXXXX----x----xxX[]----------x-------xxx-----[]--x----------xxx---x-------
B-xx-X--x---------------xXXXXXX-SS--x--xxXX[]-----------x-----xx<>-----[]---x--------xx<>--XX----SS-
xxx--X---xxxxxxxxxxxxxxxXXXXXXX------xxx---[]------E-----xxxxxx-[]-----[]-E--xxxxxxxxx-[]--XXX---SS-
XXX--XXXXXXXXXXXXXXXXXXXXXXXXX-S--XXXXXXXXXXXX-----X---XXXXXXXXXXXXXXXXXXXXXXXXXXXXXXXXXXXXXXXX-----