----------------------------------------------------------------------------------------------------
----------------------------------------------------------------------------------------------------
--------------------xSSSS------[]-------------------------------------------------------------------
-------------------------------[]----------------xxx------------------------------------------------
-------------------------------[-------------xxxxx--x--------------------------------------xxxx-----
-----x-------------------xxx---S------------xxXSSS---x--------------E-------------------E-xxXXXx----
--------------xxx-------xx--xx-------------xxXXXX-----x---------------xxxx---------------xxXXXX-x---
-------------xxX-x-----xxXX-X-x-----------xxXXXXX------x-----xxxxx---xx---x-------------xxXXXXX--xXX
-------xxxxxxxXX--x---xxXXX-E--x---------xxXXXXXX-------x-x-xx----x-xx-----x----------xxxXXXXXX---x-
----SSxx---XXXXX---x-xxXXX-<>---x-------xxXXXXXXX--------xxx<>-----xx]------xx-------xx<>XXXXXX----x
xxx---<>---XXXXX----xxXXXX-[]----x-----xxXXXXXXXX--------<>-[]-----<>]-----<>-x-----xx-[]XXXXXX-----
<>-x--[]---XXXXX----XXXXXX-[]-----x---xxXXXXXXXXX--------[]-[]-----[]]-----[]--x---xxXX[]XXXXXX-----
[]--xx[]---XxXXX----XXXXXX-[]------xxxxXXXXXXXXXX--------[]-[]-----[]]-----[]---xxxx-XX[]XXXXXX-----
XXXXXXXXXXXXXXXX----XXXXX--XXXXXXXXXXXXXXXXXXXXXXXXXXXXXXXXXXXXXXXXXXXXXXXXXXXXXXXXXXXXXXXXXXXXXXXXX