--------------------------------------------------
--------------------------------------------------
---------------------------SS---------------------
---------------------------[]---------------------
-xxxxxxx-------------------[]---------------------
xx-QQQQ-x------------------<>---------------------
x--------x----------------------------------------
----------x-----------------E---------------------
---SSSS----x-------------xxxx---------------------
X-----------x-----------xx<>-x-QQQQQQ?QQQQ-----xxx
X------------x---------xx-[]--x---------------xx-X
X-------------x-------xx--[]---x-------------xx--X
]------------X-xxxxxxxx---[]----xxxxxxxxxxxxxxX---
XXXXXXX------XXXXXXXXXXXXXXXXXXXXXXXXEEXXXXXXXX---