-----------------------XXXXXXXXXXXXXXXXXXXXXXXXXXX--XX-XXXXXXXXXXXXXXXXXXXXXXXXXXXXXXX-XXXXXXXXXXXXY
----------------------------------------------------------------------------------------------------
----------------------------------------------------------------------------------------------------
--------------------------------------------------?SSSSSSSSSSSSSSSSSSSSSSSSSSSSSSSSSSSSSSSSSS-SSSSS-
------------------xx-------------------------------------------------------------------------------x
--------------------x-----------------------------------------------------------------------------xx
------------------<--x-----------------------------------ooo--------------------------------xxxxxxx-
------------------[---x------------------------------------------------------------xx------xxSSSSSS-
------------------[-----xxxxxx---------------------------SSS----------------------xx------xx-SSSSSS-
---------xxx-----SXESQQxx--<>-x------------------S-------SSS------xxxx-----------xx--xxxxxx--SSSSSS-
-------xxx--xxx---->---[>--[]--x---------------------------------xx<>-x--------xxx---SSSSSS--SSSSS<>
xxx--xxx<>--<>-x---]---[]--[]---x-------------------------------xx-[]--x------xx<>---SSSSSS--------]
---xxxx-[]--[]--xxx]---[]--[]----x------------o---xxx-xxx------xx--[]---x----xx-[]---SSSSSS--------]
X-XXXXXXXXXXXXXXXXXXXXXX]--[]-----xxxxxxxxxxxxxxxxx--xx--xxxxxxx---[]----xxxxx--[]---SS-SSS--------]