----------------------------------------------------------------------------------------------------
----------------------------------------------------------------------------------------------------
----------------------------------------------------------------------------------------------------
----------------------------------------------------------------------------------------------------
----------------------------------------------------------------------------------------------------
-----------------------xxxx------------------XX--------------------------QQQ?QQQQQQQSSSSSSSSS-------
-----------------------x<>-x-----------------[]-----------------------------------------------------
-----------------------x[]--x----------------[]-----------------------------------------------------
-----------------E----xx[]---x----xxxx-------[]--------------------------------------xE---E---------
S--------------------xxS[]----x--xx---xx-----<>SSSSSS----X-----------------SSSSSSSSSSSSSSSSSS------x
-------------oo-----xx--[]-----xxx----X-x----------------X----------------------------------------xx
-------------oo----xx---[]------x-----XX-xx---Exxx-------X----------------E---E----------xxx-----xxX
xxxxxxxxxxxxxxxxxxxx----[]------B-----XXXX-xxxxxE-xxxxxxxxxxxxxxxxxxxxxxxxxxxxxxxxxxxxxxxx--xxxxxxXX
XXEEXEXXXXXXXXXXXXXXXXXXXXXXXXXXX-----XXXXXXXXX<>XXXXXXXXXXXXXXXXXXXXXXXXXXXXXXXXXXXXXXXXX--XXXXXXXX