--------------------------------------------------
--------------------------------------------------
--------------------------------------------------
--------------------------------------------------
-------------------------------------xxxx---------
-----xxxxx--------------------------xxXX-x--------
----xx-<>-x------------------------xxXXX--x-------
---xx--[]--x----------------------xxXXXX---x------
-xxx---[]---x--------------------xxXXXXX----x-----
xx<>--QQQ?---x------------------xxXXXXXX-----x----
<>[]----------x-------xxxx-----xxXXXXXXX------x---
[][]-----------x-----xx<>-x---xxXXXXXXXX-------x--
[][]------E-----xxxxxx-[]--xxxxXXXXXXXXX--------xx
XXXXX-----X---XXXXXXXXXXXXXXXXXXXXXXXXXXXXXXXXXXXX