----------------------------------------------------------------------------------------------------
-------------------------------------------------------------------xxx------------------------------
------------------------------SSSSSSS-S---------------------------xx--x------------SSSSSSSSSSSSSSSSS
------------------------------[]---------------------------------xx----x-------------[]----[]-------
--------xxxxxxxxxxx-----------[]----------xxxx-------------------xS-----x------------[]----[]-------
-------xx--QQQ?QQQ------------<>------xxxxx---x------------------x-------x-----------[]----[]---QQQQ
------xx-----------------------------xxXXXX----x----------------xx--------x----------<>----[]-------
-----xx------E-----------------E-----xXXXX------x--------------xxS---------x---------------[]-------
---xxx-----SSSSSSSx----------------xxxXXXX-E---S-x-------o---xxx------------x--------------[]--xxxxx
--xx<>-------------x---------xxxx-xx<>XXXX<>------xxx-------xx<>-------X-----x-------------[]-xxSSSS
-xx-[]-------X------x-------xx---xxX[]XXXX[]<>----<>-x-----xx-[]------XX------x------------<>xx-SSSS
xx--[]-------X-------x-----xx---<>XX[]XXXX[][]----[]--x---xx--[]-----XXX-------x----xxx-----xx--SSSS
E>--[]----E--X------X-xxxxxx----[]XX[]XXXX[][]----[]---xxxx---[]---X-XXX------X-xxxxx--xxxxxx---SSSS
X]-XXXXXXXXXXXXXXXXXXXXXXXXX----[]XXXXXXXXXXXXXXXXXXXXXXXXXXXXXXXXXXXXX--XXXXXXXXXXXX--XXXXXXE--XXXX