----------------------------------------------------------------------------------------------------
--------------xxxxxxxxxxxx--------------------------------------------------------------------------
SSSSSSSSS---xxxSSSSSSSSSSS--------------------------------------------------------------------------
S--------xxxxSS-------------------------------------------------------------------------------------
S--------xSSS--------------------------------------------xxxx--------------------------------E------
---------x----------E----------------------------------xxx--------SSSSSSSS------------------SQS--SQS
--------xx---------<>---------------------------------xx-x------------------------xxxx--------------
-------xxS---------[]--------------------------------xx--------------------------xxXX-x-------------
o----xxx-------XX--[]------------------------------xxx---S---------E---E--------xxXXX--x------------
S---xx<>------XXX--[]-----------------------------xx<>------Ex---SSSSSSSSS-----xxXXXX---x---SQS--S?S
S--xx-[]-----XXXX--[]---SS----------------E------xx-[]-----<>-x---------------xxXXXXX----x----------
S-xx--[]----XXXXX--[]---SS----------------------xx--[]-----[]--x-----Exxx----xxXXXXXX-----x---------
xxx---[]---XXXXXX--[]---SSxxxxxxxxxxxxxxxxxxxxxxxE--[]-----[]---xxxxxxx--xxxxxXXXXXXX-----Exxxxxxxxx
XXXXXXXXXXXXXXXXXXXXXX--XXXXXXXXXXXXXXXXXXXXXXXXXXXXXXXXXXXXXXXXXXXXXXX--XXXXXXXXXXX--XXXXXXXXXXXXXX