-------E------------------------------------------
--------------------------------------------------
----------------------------------E---------------
--------------------------------------------------
-----------------------xxxxx----------------------
-------------xxxxx----xxXX--x---------------------
------------xx----x--xxXXX---x-----------------XXX
-------xxx-xxX-----xxxXXXX----x-------------------
----xxxx--xxXX------xXXXXX-----x------------------
--xxxX<>--XXXX------XXXXXX------x--------------xxx
ExxXXX[]--XXXX-----XXXXXXX-------x------------xxX-
xxXXX-[]--XXXX----XXXXXXXX--------xxx--------xx---
xXXXX-[]--XXXX---XXXXXXXXX--------XX-xxxxxxxxx----
XXXX--XX--XXXXXXXXXXXXXXXXXXXXXXXXXXXXXXXXXXXX----