----------------------------------------------------------------------------------------------------
----------------------------------------------------------------------------------------------------
-----------------------oo---------------------------------------------------------------------------
------------------------------------xxx-------------------------------------------------------------
---------------------------------xxxx--x------------------------------------------------------------
-----------------------XXX------xx-XX---x-----------------------------------------------------------
-------------------------------xx--------x----------------------------------------------------------
------------------------------xx----------x---------------------------------------------------------
-------------------------xxxxxx-------SS---x------------------B-------------------------------------
----------------XXXX----xxXXXXX-------------x---------B-------b------------------------------------X
-----------------------xx--------------------x--------b--?-B------?QQ------------------------------X
xx-------xxx----xxx---xx----------------------x-------B----b------------------xxxx-----xxxxx-xxx---X
X-xxxxxxxx--xxxxx--xxxx----------------------X-xxxxxxxxxxxxxxxxxxxxxxxxxxxxxxxx---xxxxxx----xx--xxxx
XXXXXXXXXX--XXXXX--XXXX---------XXXX--XXXXXX-XXXXXXXXXXXXXXXXXXXXXXXXXXXXXXXXXX---XXXXXX--X-XX--XXXX