--------------------------------------------------
--------------------------------------------------
--------------------------------------------------
--------------------------------------------------
--------------------------------------------------
-SS-------------SSS-----E-----------------xxxx----
-----------------------<>----------------xx---x--x
-----------------------[]------xxxxx----xx-----xxx
----------xxxxx--------[]----xxx----x-xxx-------xX
SSS---xxxxx-XX-xSSS----XXX--xx<>-----xx<>-------XX
-----xxXX<>-XX--x----------xx-[]----E<>[]------XXX
x---xxXXX[]-XXX--x--------xx--[]---<>[][]-----XXXX
-xxxxXXXX[]-XXX---xxxxxxxxx---[]---[][][]----XXXXX
XXXXXXXX-XXXXXXXXXXXXXXXXXXXXXXXXXXXXXXXXXXXXXXXXX