--------------------------------------------------
--------------------------------------------------
--------------------------------------------------
--------------------------------------------------
--------------------------------------------------
---------------xxxxx-------------------SSSSSS-----
--------------xx-<>-x-----------------------------
-------------xx--[]--x----------------------------
-----------xxx---[]---x----------------------xxxx-
xx--------xx<>--QQQ?---x--------------------xx<>-x
o-x------xx-[]----------x-------xxxx-------xx-[]--
S--x----xx--[]-----------x-----xx<>-x-----xx--[]--
S---xxxxx---[]------E-----xxxxxx-[]--xxxxxx---[]--
XXXXXXXXXXXXXXX-----X---XXXXXXXXXXXXXXXXXXXXXXXXXX