--------------xxx-----------------------------------------------------------------------------------
------xxxxxxxxx--x----------------------------------------------------------------------------------
---[]SSSSSSSSSS---x---------------------------------------------------------------------------------
---[]SSSSSSSSSS----x--------------------------------------------------------------------------------
---[]SSSSSSSSSS-----x-------------------------------------------------------------------------------
---[]SSSSSSSSSS------x------------------------------xxxxS-------SSS---------------------------------
---[]SSSSSSSSSS-------x----------------------------xx--xxx------------------------------------------
---[]SSSSSSSSSS--------x--------------------------xx------x-xxx-------------------------------------
----]SSSSXXXXXX-------E-x------------------------xx----E-EExx--xx----------------------xx-----------
xxx-]SSSSXXXXXX------<>--x------E--S------------xxX--------XX-XX-x--------------------xx-x---------x
xSSSSSSSSXXXXXX------[]---x----<>---------E----xxXXX-------XX-XX--x------------------xx---x-------xx
xSSSSSSSSXXXXXX------[]----x-------------<>---xxXXXX-------XX-XXX--x-------xxx------xx-----------xxX
-XXSSSSSXXXXXXX------[]--E--xxxxxxxxxxxxxxxxxxxXXSX--------X--XXX--ExxxxxxxxE-xxxxxxx-----XxxxxxxxXX
XXXXXXXXXXXXXXX--XXXXXXXXXXXXXXXXXXXXXXXXXXXXXXXXXX--S-----X--XXXXXXXXXXXXX<>XXXXXXXX-----XXXXXXXXXX