----------------------------------------------------------------------------------------------------
----------------------------------------------------------------------------------------------------
----------------------------------------------------------------------------------------------------
----------------------------------------------------------------------------------------------------
---------------------------------E--------------------------------------------------ooo-------------
-E------E------------------------S-----------------XX-------------------------------ooo----------xxx
-----------------------------------------------xxx----------------------------------------------xx--
xxxxxxxxx------------------------?------------xxX-x---------------------------------xxxx-------xx---
SSSSSSSS-x-------------xxxx------------------xx-E--x----------xxx------------------xx---xxxxxxxx----
----------x--------QQ-xx-X-x----xxx---------xx--X---x--------xxS-xS--------------Exx---XXXXXEXx-----
oooooo-----x---------xx--X--x--xxX-x-------xxE--X----x---xxxxx----x-------xxxxxxxxx----X------X-----
------------xxxx----xx---X---xxx-X--x-----xx-X--X-----x-xx---SS-SS-------xxXXXXXXXX----X------X-----
oooooo-------x--xxxxx----X----x--X---xxxxxx--X--X------xxX---SS-SS-xxxxxxx--------X----X------X-----
XXXXXXXX-----X--XXXXX--XXXXXXXXXXXX-XXXXXXX--X--X-----XXXXXXXXXXXXXXXXXXXX--------X----X------X-----