----------------------------------------------------------------------------------------------------
----------------------------------------------xxxxxxxxxxxxxxxxxxxxxxxxxxxxxxxxx---------------------
SSSSSSSSSSSSSSSSSSSSSSSSSSSSSSSSSSSSS---S----xxSSSSSSSSSSSSSSSSSSSSSSSSSSSSSSS-x--------------------
SSSSSSSSSSSSS]SSSSSSSSSSSSSS------------S---xx----------------------------------x-------------------
SSSSSSSSSSQSS]SSSSSSSSSSSSSS-----------XXX-xx------------------------------------x------------------
SSSSSSSSSSSSSSSSSSSSSSSSSSSS--QQ------xxxx-xSSS-----------E-----------------------x-------SSSSSS----
----------------------]--------------xx---xx-------------<>------------------------x----------------
xxxx------------------?----xxx-xxx--xx-----xS------------[]-------------------------xxxx-------xxx--
x?-xxxxxxxxxxxxxxxxxxxxxxxxx--xx--xxx------S-S-----------[]-------S------------------xB-xxxxxxxx--x-
S??SSSSSSSSSSSSSSSSSSSSSSSSS--QQ--QQQ---------S-----E--SS[]SS---E---E---------------XXXXXESSSSSS---x
---SSSSSSSSSSSSSSSSSSSSSSSSS-----------------------<>----[]----<>--<>--------------XXXXXXX----------
---SSSSSSSSSSSSSSSSSSSSSSSSS-----------------------[]----[]----[]--[]-------------XXXXXXXX----------
oooSSSSSSSSSSSSSSSSSSSSSSSSS-----------------------[]-E--[]----[]--[]--------E-E--XXXXXXXX----------
XXXXXXXXXXXXXXXXXXXXXXXXXXXXXXXXXXXXX------XXXXXXXXXXXXXXXXXXXXXXXXXXXXXXXXXXXXXXXXXXXXXXXXXXXXXXEXX