----------------------------------------------------------------------------------------------------
----------------------------------------------------------------------------------------------------
----------------------------------------------------------------------------------------------------
----------------------------------------------------------------------------------------------------
----------------------------------------------------------------------------------------------------
----------------------------------------------------------------------------------------------------
----------------------------------------------------------------------------------------------------
----------------------------------------------------------------------------------------------------
------------------------------------------------<>-------------------------------E-------------xxx--
xx---------------xxx----------------------------[]---?QQQQQQQ?------------------QQQ-----------xxS-x-
B-xx--E---------xxX-x---------------------------[]---------------------------XXQ-------------xx----x
b-S-x--------B-xx-X--x--------E-xxx-------------[]---B-----------------?--------------<>----xxSS-SSx
B----xxxxxxxxxxx--X---xxxxxxxxxxx--xxxxxxxxxxxxxx]---b-E-----B-----E------------------[]----xXSS-SSX
XXXXXXXXXXXXXXXX--XXXXXXXXXXXXXXX--XXXXXXXXXXXXXXXXXXXXXXXX-XXXXXXXXXXX-XXXXXXXXXXX---XXXXXXXXXXXX-X