----------------------------------------------------------------------------------------------------
----------------------------------------------------------------------------------------------------
----------------------------------------------------------------------------------------------------
----------------------------------------------------------------------------------------------------
--------------------------------------------------------------------------------------------------xx
--------------------------------------------------E--S-------------------------------------------xx-
-------------------------------------------------<>---------------------------------------------xx--
-------------------------------------------------[]--------------------------xxxxx-------------xx---
o-----------------------S----------------xxxx----[]--------xxxxxxxxx-------xxx--S-x------o---xxx--o-
-------------------------------xxx------xx<>-x---XXS------xx-XXXXXXXx-----xx<>-----xx-------xx<>----
--------------xxxx-----xxx----xxX-x----xx-[]--x-----xxxx-xx----------x---xx-[]----<>-x-----xx-[]----
-------------xx<>-x-XXxxS-x--xx-X--x--xx--[]-S-x---xx<>-xx------------x-xx--[]----[]--x---xx--[]----
xxxxxxxxxxxxxx-[]--xxxx-S--xxx--X---xxx---[]-S--xxxx-[]-->-------------xx---[]----[]---xxxx---[]----
XXXXXXXXXXXXXXXXXXXX<>XXXXXXXXXXXXXXXXXXXXXXXXXXXXXXXXXX[]----------XXXXXXXXXXXXXXXXXXXXXXXXXXXXXXXX