----------------------------------------------------------------------------------------------------
----------------------------------------------------------------------------------------------------
------------------------------------xxx-------------------------------------------------------------
------------------------------------xS-x------------------------------------------------------------
---------------------------------xxx>---x-----------------------------------------------------------
x-------------E--S---SSS--------xx--]----x------------E--S---SSSSSSSSS------------SS---SS-----------
-xx----------<>----------------xx---------x----------<>---------------------------------------------
<>-x---------[]---------------xx-----------x---------[]---------------------------------------------
[]--x--------[]-------------xxx-------------xxx------[]------------xxxx---------SS-------------xxxxx
[]---x------SXXS-----------xx<>----SS-------<>-x----SXXS----------xx--xxx-xxx---------SSS--xxxxx-XX-
S]SSSS----------xxxx------xx-[]-------------[]--xx------xxxx-----xx------xx--xxx----------xxXX<>-XX-
S]SSSSxxx------xx<>-x----xx--[]-------------[]-<>-x----xx<>-x---xx-------<>--<>-x-xxxxx--xxXXX[]-XXX
S]SSSSXX-xxxxxxx-[]--xx-xx---[]-------------[]-[]--xxxxx-[]--xxxx--------[]--[]--xx----xxxXXXX[]-XXX
XXXXXXXXXXXXXXXXXXXX-X-xx-XXXXXXXXXXXXXXXXXXXXXXXXXXXXXXXXXXXXXXX------XXXXXXXXXXXX-X-XXXXXXX-XXXXXX