--------------------------------------------------
--------------------------------------------------
--------------------------------------------------
--------------------------------------------------
--------------------------------------------------
-----E--S---SSSSSSSSS------------SS----SS---------
----<>--------------------------------------------
----[]--------------------------------------------
----[]------------xxxx---------SS---------------xx
---SXXS----------xx--xxx-xxx----------SSS---xxxxx-
xx-----xxxx-----xx------xx--xxx------------xxXX<>-
>-x---xx<>-x---xx-------<>--<>-x-xxxxxx---xxXXX[]-
]--xxxx-[]--xxxx--------[]--[]--xx-----xxxxXXXX[]-
X--XXXXXXXXXXXXX------XXXXXXXXXXXX-X--XXXXXXXX-XXX