----------------------------------------------------------------------------------------------------
----------------------------------------------------------------------------------------------------
SSSSSSSS----SSSSSSSSSSSSSSSSSSSSSSSSSSSSSSSSSSSSSSSSSSSSSSSSSSSSSSSSSSSSSSSSSSSSSSSSSSSS-----SSSSSSS
-----------------------------------------SSSS[SS---------------------------S--SSSSSS--[]------------
-------------------xxx-------------------SSSS[SS---------------------------S--SSSSSS--[]------------
---------xxxxxxxxxxx---------------------SSSSSSS--------oooo------------SS--------SS--[]------xxxxxx
--------xx-SSSSSSSS---xxxxx---------------------------------------------SS--------SS--[]------xSSSSS
-------xx--SSSSSSSSS--SSSS-x----------------------------SSSX---<>-------SS--------SS--[]------xSSSSS
---xxxxx---SSSSSSSSS--SSSS--xxxxxxxxxxxxxxxxxxxxx----XXoS--X---[]-------SS----ooooSS--[]---xxxxSSSSS
--xx-XXX-------S---S--SSSS?SS?SSSSS???S??SSSSSSS-x---XSSS--Q--QQQQ------SSSS--SSSSSS--<>--xx--?SSSSS
xxx--------------------------SSSSSSSSSSSS---------x-----------------------SS-------------xx---------
xXX-----------------<>-------SSSSSSSSSSSS----------x-------E--------------SS------------xx----------
XXX-------------E---[]--------------------------EE--xxxxxxxxxxxxxxxxxxxxxxxxxxxxxxxxxxxxx-----------
XX---------XXXXXXXXXXXXXXXXXXXX-XX-XXXXXXXXXXXXXXXXXXXXXXXXXXXXXXXXXXXXXXXXXXXXXXXXXXXXXX----XXXXXXX