----------------------------------------------------------------------------------------------------
----------------xxxxxxxxxxxxxxxxxxxxxxxxxxxxxxxxxxxxxxxxxxxxxxx-------------------------------------
QQXXSS---------xxSSSSSSSSSSSSSSSSSSSSSSSSSSSSSSSSSSSSSSSSSSSSS-x-----XX---------------SSSSSSSSSSSSSS
-<]-----------xx------------------------------------------------x-------------------------[]---[]---
-[]------XXX-xx--------------------------------------------------x------------------------[]---[]---
-[]-----xxxx-xSSS------------E------------------------------------x-----------------------[]---[]---
-------xx---xx--------------<>-------------------------------------x----xxxxx-------------<>---<>---
------xx-----xS-------------[]--------------------------------------x--xxXXX-x----------------------
-xxxxxx------S-SS--S--------[]-------S--------------------E----------xxxXXXX--x---------------------
xxXXXXX----------SS----E--SS[]SS---E----E----------------<>-----------xXXXXX---x--------------------
x---------------------<>----[]----<>---<>-------------XX-[]--XXX-----XXXXXXX----x-------------------
----------------------[]----[]----[]---[]------------XXX-[]--XXX-----XXXXXXX-----xx------xxx--xxx---
----------------------[]-E--[]----[]---[]---x----B-E-XXX-[]--XXX-----XXXXXXX-----X-xxxxxxx--xxx--xxx
XX-----------XXXXXXXXXXXXXXXXXXXXXXXXXXXXXXXXXXXXXXXXXX--XX--XX------XXXXXXX--XXXXXXXXXXXX--XXX--XXX