--------------------------------------------------
--------------------------------------------------
--------------------------------------------------
--------------------------------------------------
--------------------------------------------------
--------------------------------------------------
--------------------------------------------------
----------oooooo----------------------------------
x-----------xx---------------------------------xx-
-xxxxxxx---xx-x--------------E---------xxxxx--xx-x
---x----x-xx---x-----------QQ?-QQ-----xx----xxx---
E-XX-----xx-----xxx------------------xx------x----
Q-XX-----<>-----XX-xxxxxxxxxxxxxxxxxxxX------X----
XXXX-----[]------XXXXXXXXXXXXXXXXXXXXXX------X----