----------------------------------------------------------------------------------------------------
----------------------------------------------------------------------------------------------------
----------------------------------------------------------------------------------------------------
------------------------------xxx--------------------------------------------------------xxx--------
--------------------xxxx----xxx--x---------------------------------------------xxxx----xxx--x-------
----------S--------xx---x--xxXS---x------------------------E---------S--------xx---x--xxXS---x------
------------------xx-----xxxEX-----x----------------------<>-----------------xx-----xxxEX-----x-----
-----------------xx-------xXXX------x---------------------[]----------------xx-------xXXX------x----
------------xxxxxx--------XXXXS------x-------------Q?-----[]-----------xxxxxx--------XXXXS------x---
xxx----Q--xxx---<>-------XXXXX--------x---------B---------XXX-----Q--xxx---<>-------XXXXX--------x--
x--xxx---xx<>---[]------XXXXXX---------x--------b------------xxxx---xx<>---[]------XXXXXX---------x-
>--<>-x-xx-[]---[]-----XXXXXXX----------x-------B--Exxxx----xx<>-x-xx-[]---[]-----XXXXXXX----------x
]--[]--xx--[]---[]----XXXXXXXX---------X-xxxxxxxxxxxx---xxxxx-[]--xx--[]---[]----XXXXXXXX---------X-
XXXXXX-XXX-XX--XXXXX-XXXXXXXXXXXXXXXXX-XXXXXXXXXXXXXX---XXXXXXXXX-XXX-XX--XXXXX-XXXXXXXXXXXXXXXXX-XX