----------------------------------------------------------------------------------------------------
----------------------------------------------------------------------------------------------------
------E---------------------------------------------------------------------------------------------
x---------------------------------------------------------------------------------------------------
----------------------------------xxx--------oo-----------------------------------------------------
SSSSSS?S-------------------------xx--x--------------------------------------------------------------
-----------------S--------------xx----x-------------------------------------------xxxx--------------
-------------------------------xx------x-----------------------------------------xx---x-------------
----------------xxxx-----o---xxx--o-----xxx-------------------------------------xx-----xxx------S---
---------------xx<>-x-------xx<>--------<>-x----------------------------------xxx------<>-x---------
--------------xx-[]--x-----xx-[]--------[]--x-----xxxx-----------------------xx<>------[]--x---xxx--
x------------xx--[]---x---xx--[]--------[]---x---xx<>-x--------xxxxx-xxx----xx-[]------[]---x-xxS-x-
Xxxxxxxxxxxxxx---[]----xxxx---[]--------[]-E-Exxxx-[]-Exxxxxxxxx----xx--xxxxx--[]-E----[]----xx-S--x
XXXXXXXXXXXXXXXXXXXXXXXXXXXXXXXXXXXXXXXXXXXXXXXXXXXXXXXXXXXXXXXX---XXX--XXXXXXXXXXXXXXXXXXXXXXXXXXXX