----------------------------------------------------------------------------------------------------
----------------------------------------------------------xxx---------------------------------------
---------------------------------------------------------xx--x--------------------------------------
--------------------------------------------------------xx----xx------------------------------------
------------------------------xxxxxx-------------------xx-----E-xxxxxx------------------------------
-----------------------------xx?SSS-x-------S--------xxx---------x----x--------SSSSSS---------------
-----------------------------x-------x--------------xx-S--------<>-----x----------------------------
------------------------xxxxxx--------x------------xx-----------[]------xxxx--------xxx------------x
------xxxxx------------xx---xE---------xxx--------xx------------[]-------xB-xxxxxxxxx--x----------xx
QQxxxxx----x----------xx----<>---------<>-x------xx-------X-----XX-------XXXXEXSSSSSS---x-------xxx-
-xx--<>-----x-------xxx-----[]--<>-----[]--x----xxE---------------------XXXXXXX----------x-----xx<>-
xx---[]------x-----xx<>-----[]--[]-----[]---x--xx<>--------------------XXXXXXXX-----------x---xx-[]-
xX---[]-E-----xxxxxx-[]--E--[]--[]-----[]----xxx-[]-----X-------------XXXXXXXXX----------B-xxxx--[]-
XX---XXXXXX---XXXXXXXXXXXXXXXXXXXXXX---XXXXXXXXXXXXXXXXXX-------------XXXXXXXXXXXXXXXXEXXXXXXXXXXXXX