----------------------------------------------------------------------------------------------------
----xxx---------------------------------------------------------------------------------------------
SS-xx--x------[-------------------------------------------------------------------------------------
--xx----x------------------------------------------------------------------------------------<------
-xx------x------------xxxxx------------------------------------------------------------------]------
xx------E-xxxxxxxxxxxxx----xxxxxxxxxxxxxx---------E----------------------------------E-------]------
SS--------SSSSSSSSSSSSS----SSSSSSSSSSSSX-x------------E----------------------------------E---]------
S--------------------------------------X--x---E----------------------------------E------------------
---------------------------------------X---x--------------------------------------------------------
--S---------------E--------------------X--E-x----------------------------E--------------------------
-S---------------<>------S------------?X-<>--x------------------?QQ-----<>--------------------------
-S---------------[]--------------------X-[]---x-------------------------[]-------------------------B
oS---------------[]----------------<>--X-[]----x---xxxxx----B-----------[]-----xxxx---xxxxx--------b
XX---------------[]----------------[]--X-[]-E---xxxx----xxxxxxxxxxxxxxxxxxxxxxxx---xxxx----xxxxxxxxx