----------------------------------------------------------------------------------------------------
----------------------------------------------------------------------------------------------------
E-------------------------------S-------------------------------------------------------------------
----------------------------------------------------------------------------------------------------
----------------------------------------------------------------------------------------xxxxx-------
------------------------------XXXX-----------------------------------------------------xxXX--x------
------------------------------XXX---------------------------------------------E-------xxXXX---x-----
-------------------------------------------------------------------------------------xxXXXX----x----
-----------------B-xxxx--xxx--------------------------------------------------------xxXXXXX-----x---
xxxxxxxxxxxxxxxxxxxx---xxx--x------------------------------------------------------xxXXXXXX---S--x--
xXXXXXXXXXXXXXXXXXXX---XXX---x---------------------------------Q?QQQo-------------xxXXXXXXX-------x-
XXXXX------------------XX-----xx---------------xxx-------------------------------xxXXXXXXXX--------x
XXXXX------------------------XX-xxxxxxxxxxxxxxxxE-xxxxxxxxxxxxxxxxxxxxxxxxxxxxxxxxXXXXXXXXX--------X
XXXXX------------------------XXXXXXXXXXXXXXXXXXXXXXXXXXXXXXXXXXXXXXXXXXXXXXXXXXXXXXXXXXXXXXXXXXXXXXX