----------------------------------------------------------------------------------------------------
-----------------------xxxxxxxxxxxxxxxxxxxxxxxxxxxxxxxxxxxxxxxxxxxxxxx------------------------------
SSSSSSSSSSSSSS--------xxSSSSSSSSSSSSSSSSSSSSSSSSSSSSSSSSSSSSSSSSSSSSS-x------------SSSSSSSSSSSSSSSSS
SSSSS----------------xx--------------X---------------------------------x-------------[]----[]-------
SSSSS-----------XXX-xx--------------------------------------------------x------------[]----[]-------
SSSSS--QQ------xxxx-xSSS------------E------------------------------------x-----------[]----[]---QQQQ
--------------xx---xx--------------<>-------------------------------------x----------<>----[]-------
----xxx-xxx--xx-----xS-------------[]--------------------------------------x---------------[]-------
xxxxx--xx--xxx------S-S------------[]-------S--------------------E----------x--------------[]--xxxxx
SSSSS--QQ--QQQ---------S------E--SS[]SS---E----E---------S------<>-----------x-------------[]-xxSSSS
SSSSS------------------------<>----[]----<>---<>-------------XX-[]--XXX-------x------------<>xx-SSSS
SSSSS------------------------[]----[]----[]---[]------------XXX-[]--XXX--------x----xxx-----xx--SSSS
SSSSS------------------------[]-E--[]----[]---[]--------E-E-XXX-[]--XXX-------X-xxxxx--xxxxxx---SSSS
XXXXXXXXXXXXXX------XXXXXXXXXXXXXXXXXXXXXXXXXXXXXXXXXXXXXXXXXX--XX--XX------XXXXXXXXX--XXXXXXE--XXXX