----------------------------------------------------------------------------------------------------
------------------------------------xxx-------------------------------------------------------------
-------E---------------------------xx--x------------------------------------------------------------
----------------------------------xx----xx----------------------------------------------------------
---------------------------------xx-----E-xxxxxx----------------------------------------------------
-QSSSSS?S--------S----S--------xxx---------x----x-------SSSSSSSS----------------------SSSSS---------
[]----------------------------xx-S--------<>-----x--------------------------------------------------
[]---------------------------xx-----------[]------xxxx---------xxx----------------------------------
[]--------------xxxx--------xx------------[]-------xB-xxxxxxxxxx--x--------------------E------------
[]-------------xx<>-x------xx-------X-----XX-------XXXXESSSSSSSS---x------------------SSSSS-xxx-----
<>------------xx-[]--x----xxE---------------------XXXXXX------------x----------xxxx--------xxX-x--B-
xxx----------xx--[]---x--xx<>--------------------XXXXXXX-------------x----B---xx<>-x------xx-X--x-b-
xE-xxxxxxxxxxx---[]----xxx-[]-----X-------------XXXXXXXX------------B-xxxxxxxxx-[]--xxxxxxx--X---xxx
XX-XXXXXXXXXXXXXXXXXXXXXXXXXXXXXXXX-------------XXXXXXXXXXXXXXXXXEXXXXXXXXXXXXXXXXXXXXXXXXXXXXXXXXXX