----------------------------------------------------------------------------------------------------
----------------------------------------------------------------------------------------------------
----------------------------------------------------------------------------------------------------
----------------------------------------------------------------------------------------------------
----------------------------------------------------------------------------------------------------
-----------------XXXX-----------------------------------------XXXX------------------------------?SS-
----------------------------------------------------------------------------------------------------
----------------------------------------------------------------------------------------------------
-----------------------------------------xxxx-------------------------------------------------------
oo--------------------------------------xxX--x------------------------------------------------------
---------xxx---------------------------xx-X---x-------xxx------------------------------------E---B--
-xxx----xxB-x-------------xxx-xxx-----xx--X----x-----xxB-x-----------xxx-xxx------------B--------b--
xx--xxxxx-b--xxxxxxxxxxxxxx--xx--xxxxxx--EX-----xxxxxx-b--xxxxxxxxxxxx--xx--xxxxxxxxxxxxxxxxxxxxxxxx
XX--XXXXXXXXXXXXXXXXXXXXXXX--XX--XXXXXXXXXX-----XXXXXXXXXXXXXXXXXXXXXX--XX--XXXXXXXXXXXXXXXXXXXXXXXX