----------------------------------------------------------------------------------------------------
----------------------------------------------------------------------------------------------------
SSSSSSSSSSSSSSSSSSS?SSSSSSSSSSSSSSSSSSSSSSSSSSSSSSSS---------------------------------------------SSS
-------------------------------------------------------------------------------------------------[]-
------------------------------------------------------XXX----------------------------------------[]-
----------------oooo-----------------------------------------------------xxxxx-------------------[]-
-xxx-----------------------------------------------------------E--------xx-<>-x------------------[]-
xx--x---------S-SSSS-SS------------------------------------------------xx--[]--x-----------------[]-
x----x--------SoS--SoSS--------------------------xxxxx-----SSSSSSS---xxx---[]---x-----------------]-
------xxxx----SSS--SSSS-----------xxxx----------xxXXX-xxxx----------xx<>--QQQ?---x---------------->-
-XXXE--<>-x----------------------xxSS-x--------xxEXXX-XXX-x--------xx-[]----------x----------XXXX<--
-XXX>--[]--x-------------------Exx-SS--x------xxXXXXX------x------xx--[]-----------xx-------SX----E-
EXXX]--[]---xxxxxxxxxxxxxxxxxxxxx--SS---xxxxxxxXXXXXX-------xxxxxxx---[]------E----X-xxxxxxxxxxxxxxx
XXXXXXXXXXXXXXXXXXXXXXXXXXXXXXXXX--XX--XXXXXXXXXXXXX-------XXXXXXXXXXXXXX-----X---XXXXXXXXXXXXXXXXXX