----------------------------------------------------------------------------------------------------
--------------------------------------------------xxx-----------------------------------------------
SSSSSSSSS-------------SSS------------------------xx--x----------------------------XXX---------------
------------------------------------------------xx----x---------------------------------------------
-----------------------------------------------xx------x--------------------------------------------
----------xx--xxxxx--------E-------------------xX-------x-------------------------------------------
---------xx-xxx----x------->SSSSSSS-----------xx---------x------------------------------------------
--------xx--XXX-----x------]SSSSSSS----------xx-----------x-----------------------------------------
----xxxxx------------x-----]SSSSSSS--------xxx-----------E-x-------xxxx----S--?---------------------
---xx-XXX-------------xxxxx]SSSSSSS-------xx<>----------<>--x-----xx<>-x----------------------------
--xx-----------SSS-S--SSSSSSSSSSSSS------xx-[]----------[]---x---xx-[]--x---------------E---X--xxxx-
Exx------------SSS-S--SSSSSSSSSSSSS-----xx--[]----------[]----x-xx--[]---x-----xxx-E-------XX-xx<>-x
xx-------------SSS-S--SSSSSSSSSSSSSxxxxxx---[]------E---[]-----xx-E-[]----xxxxxx--xxxxxxxxxxxxx-[]--
XX----------XXXSSS-S--XXXXXXXXXXXXXXXXXXXXXXXXXXXXXXXXXXXXXXXXXXXXXXXXXXXXXXXXXX--XXXXXXXXXXXXXXXXXX