----------------------------------------------------------------------------------------------------
-----------------------------------------------------------------------xxx--------------------------
----------------------------------------------------------------------xx----------------------------
---------------------------------------------------------------------xx-----------------------------
E-------------------------------------------------------------------xx---xxx------------------------
-----------------------------------------------SSSSS---?-------xxx--xS---XX-x-----------------------
--------------------------------------------------------------xx--x-x----XX--x----------------------
-------------------------------------------------------------xx----xx----XX---x---------------------
-E----------------------------------------------------------xx------x----XX----x----------E---------
<>----------------------------------xxx-----S---E---x-----xxx-------SS---XX-----x-----------xxxx----
[--------------------xxxx----------xxX-x-------------E---xx<>------------XX------x---------xx<>-x---
b-----xxxx----------xx<>-x-------Exx-X--x---------------xx-[]------------XX-------x-------xx-[]--x--
xxxxxxx---xxxxxxxxxxx-[]--xxxxxxxxx--X---xxxxxxxxxxxxxxxx--[]E-----------XX-------Xxxxxxxxx--[]---xx
XXXXXXX--XXXXXXXXXXXXXXXXXXXXXXXXXX--XXXXXXXXXXXXXXXXXXXXXXXXXXXXXXXXXXXXXXXXXXXXXXXXXXXXXXXXXXXXXXX