-------------------------------------------------------xxx------------------------------------------
-----------------------------xxxxxxxxxxxxxxxxxxxxxxxxxxx--x-----------------------------------------
--------------X--------------xXXXXXXXXXXXXXXXXXXXXXXXXXX---x----------------------------------------
----------------------------xxXXXXXXXXXXXXXXXXXXXXXXXXXX----x---------------------------------------
------------x--------------xx-XXXXXXXXXXXXXXXXXXXXXXXXXX-----x-----------------------xxxx-----------
E-SSS--------Qxxx----------xS-XXXXXXXXXXXXXXXXXXXXXXXXXX------x----------------------x---x----------
>--------------------------x--XXXXXXXXXXXXXXXXXXXXXXXXXX-------x--------------------xx--------------
]E------------------------xx--XXXXXXXXXXXXXXXXXXXXXXXXXX--------x------------------xx---------------
]S---xxxx----------------xxS--XXXXXXXXXXXXXXXXXXXXXXXXXX----E----x---------------xxx----------------
Q---xx<>-x-Q?SQS---------x----XXXXXXXXXXXXXXXXXXXXXXXXXX---<>-----x------SSS----xx<>------x---------
---xx-[]--x------x------xx----XXXXXXXXXXXXXXXXXXXXXXXXXX---[]------x-----------xx-[]-----X---------x
--xx--[]---x------x----xx---E-XXXXXXXXXXXXXXXXXXXXXXXXXX---[]-------x---------xx--[]----XXxxxxx---xx
xxx---[]----xxxxx--xxxxx------XXXXXXXXXXXXXXXXXXXXXXXXXX---[]------X-xxxxxxxxxx---[]---XXXxE---x-xx-
XXXXXXXXXXXXXXXXXXXXXXXXXXXXXXXXXXXXXXXXXXXXXXXXXXXXXXXX--XXXXXXXXXXXXXXXXXXXXXXXXXXXXXXXX<>----xx-X