----------------------------------------------------------------------------------------------------
----------------------------------------------------------------------------------------------------
SSSSSSSSSSSSSSSSSSSS?SSSSSSSSSSSSS?SSSSSSSSSSSSSSSSSSSSSSSSSSSSSSSSSSSSSSSSSSSSSSSSS----------SESSSS
]]--------------------------------------------------------------------------------------------------
]]----E-------------------------------------------------------------------------------XXX-----------
QQQQQQQQ--------------------------------------------------------------------------------------------
----------------xxxxxx------------------------------xx----------------------------------------------
<--------------xxSSSS-x----------------------------xx-x-xxx-----------------------------------------
xxxxxxxxxxxxxxxx-SSSS--x-------E-------X----------xx---xx--x---------------------xxxxx-----SSSSSSS--
SSSSSSSSSSSSSSSS-SSSS?--x------QXXQ--QQX--------xxx----<>---x------xxxx---------xxXXX-xxxx----------
SSSSSSSSSSSSSSSS---------x---XX-XX-------------xx<>----[]----xxx--xxSS-x-------xxEXXX-XXX-x---------
SSSSSSSSSSSSSSSS----------xXXXX-XX------------xx-[]----[]----<>-xxx-SS--x-----xxXXXXX------x--------
SSSSSSSSSSSSSSSS-----------xxxxxxxxxxxxxxxxxxxx--[]----[]--E-[]--x--SS---xxxxxxXXXXXX-------xxxxxxxx
XXXXXXXXXXXXXXXXXXXXX-----XXXXXXXXXXXXXXXXXXXXXXXXXXXXXXXXXXXXXXXX--XX--XXXXXXXXXXXX-------XXXXXXXXX