----------------------------------------------------------------------------------------------------
----------------------------------------------------------------------------------------------------
---------------------------------------------------SSSSSSSSSSSSSSSSSSSSSSSSSSSSSSSSSSSSSSSSSSSSSSSSS
--------------------------------------------------------------]-------------------------------------
--------------------------------------------------------------]-------------------------------------
----------------------------------------xxx------------------->--------Q----------------------------
---------------------------------------xxX-x------------------------------------------------------xx
x-------------------------------------xxXX--x-----------------xxxx----------------------------xxxxxX
-x-----------------------------------xxXXX---x---------------xx---x--------------------------xxXXXXX
--x--------xxx----------------------xxXXXX----x-------------xx-----xxx-?-------xxxx--------oxxXXXXXX
X--x------xxX-x--------------------xxXXXXX-----x----------Exx------<>-x-------xxSS-x-------xxXXXXXXX
Q---x----xx-X--x------------------xxXXXXXX------x---------xx-------[]--x-----xx-SS--x-----xxXXXXXXXX
[----xxxxx--X---xxxxxxxxxxxxxxxxxxxXXXXXXX-------xxxxxxxxxxX-------[]---xxxxxx--SS---xxxxxxXXXXXXXXX
X--XXXXXXXXXX--XXXXXXXXXXXXXXXXXXXXXXXXXXXXXXXXXXXXXXXXXXXXX-----XXXXXXXXXXXXX--XX--XXXXXXXXXXXXXXXX