--------------------------------------------------
--------------------------------------------------
---------------------------------SSSS-------------
---------------------------------[]---------------
---------------------------------[]---------------
---------------------------------[]------S----S---
--------------------------------------------------
xx------------------------------------------------
<-x-xx-----------------oo---------------xxxx------
[--xx-xx--------------xxxx-------------xx<>-x-----
---<>---x------------xx---x-----------xx-[]--x----
X>-[]----xxx--------xx-----x---------xx--[]---x---
X]-[]----XX-xxxxxxxxx-------xxxxxxxxxx---[]----xxx
XXXXX--XXXXXXXXXXXXXX------XXXXXXXXXXXXXXXXXXXXXXX