----------------------------------------------------------------------------------------------------
---------------------------------------------------------------------xxxxxxxxxxxxxxxxxxxxxxxxxxxxxxx
--------------SSSSSSSSSSSSSSSSSSSSSSSSSSSSSSSSSSSSSSSSSSSSSS--------xxSSSSSSSSSSSSSSSSSSSSSSSSSSSSSS
-----------------------------SSSSSSSSSSSSSSSSSSSSSS----------------xx-------------------------------
xxx--------------------------SSSSSSSSSSSSSSSSSSSSSS-----------XXX-xx--------------------------------
x--x-------------------------SSSSSSSSSSSSSSSSSSSSSS--QQ------xxxx-xSSS-------------E----------------
----x-------------------------------------------------------xx---xx---------------<>----------------
-----x------------------------------xxx-----------xxx-xxx--xx-----xS--------------[]----------------
o-----x----------------------xxxxxxxx?-xxxxxxxxxxxx--xx--xxx------S-S-------------[]------S---------
-------x--------------------xx-SSSSSS??SSSSSSSSSSSS--QQ--QQQ---------S--S----E--SS[]S---E----E------
--------x------------------xx--SSSSS-o-SSSSSSSSSSSS-------------------------<>----[]---<>---<>------
---------xx--------xxx-xxxxx---SSSSS---SSSSSSSSSSSS-------------------------[]----[]---[]---[]------
---------X-xxxxxxxxx--xx--x---------oooSSSSSSSSSSSS-------------------------[]-E--[]---[]---[]------
XXXXXXXXXXXXXXXXXXXX--XX--X---XXXXXXXXXXXXXXXXXXXXXXXXXXXXXX------XXXXXXXXXXXXXXXXXXXXXXXXXXXXXXXXXX