----------------------------------------------------------------------------------------------------
----------------------------------------------------------------------------------------------------
----------------------------------------------------------------------------------------------------
-------------------xxx------------------------------------------------------------------------------
------------------xx--x----------------------------xxxxx--------------------------------------------
-----------------xxX---x------------------------E-xxXXX-x--------------------E-E-E------------S-----
x---------------xx------x------------------------xxXXXX--x------------------<><><>------------------
-x----xxxx-xxxxxx--------x----xxxxx-------------xxXXXXX---x-----------------[][][]------------------
--x-xxx---xx---x----------x-xxx----x----------xxxXXXXXX----x----------------QQQQQQ--------------xxxx
---xx<>---<>---?S----------xx<>-----xx-------xx<>XXXXXX-----x------------------------------Q--xxx---
-X-<>[]---[]-------------E-<>[]----<>-x-----xx-[]XXXXXX------x------------------------xxxx---xx<>---
XX-[][]---[]------------<>-[][]----[]--x---xx-X[]XXXXXX-------xxx--------xxx---------xx<>-x-xx-[]---
XX-[][]---[]------------[]-[][]----[]---xxxx-XX[]XXXXXX-------XX-xxxxxxxxx--xxxxxxxxxx-[]--xx--[]---
X--XXXXXXXXXXXXXXX------XXXXXXXXXXXXXXXXXXXXXXXXXXXXXXXXXXXXXXXXXXXXXXXXXX--XXXXXXXXXXXXXX-XXX-XX--X