----------------------------------------------------------------------------------------------------
----------------------------------------------------------------------------------------------------
-------------------------------------------------------------------------xxx------------------------
------------------------------------------------------------------------xx--x-----------------------
----------E-----------------------------------E------------------------xx----x----xxxxx-------------
-----QQQQQQQQQQ----------SS------------------SQS--SQS-----------------xx------x--xxXXX-x------------
[----------------------------------xxxx------------------------------xx--------xxxXXXX--x-----------
x---------------------------------xxXX-x-----------------------o-----x----------xEXXXX---x----------
-----------E-------------SS------xxXXX--x-----------------------E----x----------XXXXXX----x---------
-x--E?QQQQQXQQQ-----------------xxXXXX---x---SQS--S?S--------SSSSS--xx---------XXXXXXX-----x--------
--x----------------------------xxXXXXX----x---------------E--E-----xxX-------EXXXXXXXX------x-------
---x-------------------xxxx---xxXXXXXX-----x---------------------Exx-X-------XXXXXXXXX-------x------
----xxxxxxxxxxxxxxxxxxxx---xxxxXXXXXXX-----Exxxxxxxxxxxxxxxxxxxxxxx--X------XXXXXXXXXX-------Xxxxxxx
XXXXXXXXXXXXXXXXXXXXXXXX---XXXXXXXXXX--XXXXXXXXXXXXXXXXXXXXXXXXXXXXXXXX---XXXXXXXXXXXXXXXXXXXXXXXXXX