----------------------------------------------------------------------------------------------------
xxxxxxxxxxxxxxxxxxxxxxxxxxxxxxxxx-------------------------------------------------------------------
SSSSSSSSSSSSSSSSSSSSSSSSSSSSSSSS-x---SSSSSSSSSSSSSSSS-------------SSS--[]SSSSSSSSSSSSS--------------
SSSS------------------------------x--SSSS------------------------------[]SSSSSSSSSSSSS--------------
SSSS-------------------------------x-SSSS------------------------------[]SSSSSSSSSSSSS--------------
SSSS----E---------------------------xSSSS-------------xx--xxxxx--------[]SSSSSSSSSSSSS--------------
-------<>----------------------------x---------------xx-xxx----x-------[]SSSSSSSSSSSSS--------------
-------[]------------E----------------x-------------xx--XXX-----x------[]SSSSSSSSSSSSS--------------
E-E----[]-----------<>----------------oxxx------xxxxx------------x------]SSSSSSSSSSSSS--------------
><>---?SSS--E-------[]---------------S?SS-x----xx-XXX-------------xxxxx-]SSSSSSSSSSSSS-------E--EE--
][]--------<>-------[]--<>-----E-----SSS---x--xx-----------SSS-S--SSSSSSSSSSSSSSSSSSSS------<>--<>--
][]--------[]---<>--[]--[]----<>-----SS-----xxx------------SSS-S--SSSSSSSSSSSSSSSSSSSS------[]--[]--
][]--------[]---[]--[]--[]----[]-------E-EE--xX------------SSS-S--SSSSSSSSSSSSSSSSSSSS--<>--[]--[]--
XXXXXX----XXX---XX--XX--XX--XXXXXXXXXXX-XXXXXXX---------XXXSSS-S--XXXXXXXXXXXXXXXXXXXX--[]--[]--[]--