xx----xxxxxx--------------------------------------
--xxxxx-----xxxxxxxxxxxxxxxxxxxxxxxxxxxxxxxxx-----
[]SSSSS-----SSSSSSSSSSSSSSSSSSSSSSSSSSSSSSSS-x---S
[]----------SSSS------------------------------x--S
[]----------SSSS-------------------------------x-S
[>----------SSSS----E---------------------------xS
[------------------<>----------------------------x
[------------------[]------------E----------------
--------------E----[]-----------<>----------------
-E-----------<>---?SSS--E-------[]---------------S
<>-----------[]--------<>-------[]--<>-----E-----S
[]-----------[]--------[]---<>--[]--[]----<>-----S
-]-----------[]--------[]---[]--[]--[]----[]------
XX-----XXXXXXXXXXX----XXX---XX--XX--XX--XXXXXXXXXX