----------------------------------------------------------------------------------------------------
xx--------------------------------------------------------------------------------------------------
>-x---SSSS-------------------------XXXX-------------------------------------------------------------
]--x--SSSS--------------------------[]--------------------------------------------------------------
]---x-SSSS--------------------------[]----------------------------------xxxxxxxxxxx-----------------
]----xSSSS--------------------------[]---------------------------------xx---x---XX-x----------------
[-----x-----------------------------[]--------------------------------xx-E--E---[]--x---------------
[------x-------<>-------------------[]------------------------------xxx---------[]---x--------------
-------oxxx----[]-------------------[]------xxxx-------------------xx-E---------[]----x-------------
------S?SS-x--QQQQQQQQQQ?QQQQQQQ?Q--<>-----xxX--x-----------------xx------------[]-----xx-------S?S-
<-----SSS---x-----------------------------xx-X---x---------------xx-------------<>-----B-x----------
]-----SS-----x-xxxx----------------------xx--X----x-------------xx---------------------b--x---------
]-------E-EE--xx--Exxxxxxxxxxxxxxxxxxxxxxx--EX-----xxxxxxxxxxxxxxX---------------E-----B---xxxxxxxxx
XXXXXXXX-XXXXXXX-X-XXXXXEEXXXXXEXEXXXXXXXXXXXX-----XXEXXXXXXXXXXXX-------------XXXXXXXXXXXXXXXXXXXXX