----------------------------------------------------------------------------------------------------
----------------------------------------------------------------------------------------------------
---------------------------------------------------E--------------E------------------------E--------
-------------------------------------------------------------------------------SSSS-------[]--------
-------------------------------------------------------------------------------SSSS-------[]--------
S-------------------------------------------SSSSSSS?S-------S----S-----------xxSSSS-------[]--------
---------------ES--------------E-------------[]-----------------------------xx-x----------[]-----ooo
---------------------QQQ------<>-------------[]----------------------------xx---x---------[]-----xxx
xx----------------------------[]-------------[]------------xxxx-----------xx----oxxx------[]----xx--
S-x------------------------QQQQQQQQQQ--------[]-----------xx<>-x---------xx----S?SS-x-----[]---xx---
---x-----xxx---------------------------------<>----------xx-[]--x-------xxE----SSS---x----<>--xxE---
----x---xxB-x----------xxxxx-----------------xxx--------xx--[]---x-----xx<>----SS-----x------xx<>---
B----xxxx-b--xxxxxxxxxxxB---xxxxxxxxxxxxxxxxxxE-xxxxxxxxx---[]----xxxxxx-[]------E-EE--xxxxxxx-[]---
XX---XXXXXXXXXXXXXXXXXXXX--XXXXXEEXXXXXXXXXXXXXXXXXXXXXXXXXXXXXXXXXXXXXXXXXXXXXXX-XXXXXXXXXXXXXXXXXX