----------------------------------------------------------------------------------------------------
----------------------------------------------------------------------------------------------------
----------------------------------------------------------------------------------------------------
----------------------------------------------------------------------------------------------------
----------------------------------------------------------------------------------------------------
----------QQQQQ------------------SSQSSSS?SSS-------SSS----------------------------xxxxx-------------
--------------------------------------------------------------xxxx---------------xx-<>-x------------
-------------------------------------------------------------xxXX-x-------------xx--[]--x-----------
--xxxx--------------------E------------------------SSS------xxXXX--x----------xxx---[]---x----------
-xx<>-x--E?QQQQ----------<>------SSSSSSSSSSSS--------------xxXXXX---x----x---xx<>--QQQ?---x---------
xx-[]--x--------------------------------------------------xxXXXXX----x-----xxx-[]----------x-------x
x--[]---x----------------------------------------xxxxx---xxXXXXXX-----x---xxXXX[]-----------x-----xx
E--[]----xxxxxxxxxxxxxxxxxxxxxxxxxxxxxxxxxxxxxxxxx----xxxxXXXXXXX------xxxx----[]------E-----xxxxxx-
XXXXXXXXXXXXXXXXXXXXXXXXXXXXXXXXXXXXXXXXXXXXXXXXXX----XXXXXXXXXX--XXXXXXXXXXXXXXXX-----X---XXXXXXXXX