----------------------------------------------------------------------------------------------------
----------------------------------------------------------------------------------------------------
-----------------------------------------------?----------------------------------------------------
----------------------------------------------------------------------------------------------------
-------------------------E-----E--------------------------------xxxxx-------------------------------
--------------------SSSSSSSSSSSSS---------------------xxxxx----xxXX--x------------------------------
x------------------------------------------------SS--xx----x--xxXXX---x-----------------------------
-x--------------------------------------------------xxX-----xxxXXXX----x----------------------------
--x------------------------------------------SS----xxXX------xXXXXX-----x-------------Q?------------
---x--------xx---------xxx---SSSS---xxx-----------xxXXX------XXXXXX------x---------Q-E------S-------
----x------xB-x-------xxX-x--------xxX-x--B------xxXXXX-----XXXXXXX-------x----------E----E---------
-----x----xxb--x-----xx-X--x------xx-X--x-b----xxxXXXXX----XXXXXXXX--------x----------------xxxxxx--
E-----xxxxx-B---xxxxxx--X---xxxxxxx--X---xxxxxxx-XXXXXX---XXXXXXXXX-------X-xxxxxxxxxxxxxxxxx---X-xx
XXXXXXXXXXXXXXXXXXXXXXXXXXXXXXXXXXXXXXXXXXXXXXXX-XXXXXXXXXXXXXXXXXXXXXXXXXXXXXXXXXXXXXXXXXXXX---XXXX