--------------------------------------------------
--------------------------------------------------
--------------------------------------------------
--------------------------------------------------
--------------------------------------------------
SSS--------x--------------------------------------
---------------xxxx-------------------------------
--------------xx---x------------------------------
-------------xx-----xxx-------xxxx----S-----------
----------xxxx------<>-x-----xx<>-x---------------
---------xx-<>------[]--x---xx-[]--x--------------
xxxxxxxxxx--[]------[]---x-xx--[]---x-----xxx-----
x-------x---[]-E----[]----xx-E-[]----xxxxxx--xxxxx
X---X---X--XXXXXXXXXXXXXXXXXXXXXXXXXXXXXXXX--XXXXX