----------------------------------------------------------------------------------------------------
----------------------------------------------------------------------------------------------------
----------------------------------------------------------------------------------------------------
--xxx-----------------------------------------------------------------------------------------------
-xx--x--------------------------------------------------------------------------------------------xx
-xS---x-----------------------------------XXXX----------XXXXXXXXXXXXXXXXX------------------------xxX
-x-----x----------------------------------------------------------------------------------------xx-X
-x------x-----------------------------------------------------------------------------------xxxxxXXX
xx-------x--------------o------------------------------------------------------------------xxx-XXXXX
xS--------x---------B----------------x-----------xx-------------------------------------x-xx-X-XXXXX
-----------x--------b--?------------------------xx-x------------------------------------xxx--X-XXXXX
S-----------x-------B-------xxx----------------xx---x---------xxx-xxx-xxx-----xxx------xx<>--X-XXXXX
S----------X-xxxxxxxxxxxxxxxx--xxxxxxxxxxxxxxxxx-----xxxxxxxxxx--xx--xx--xxxxxxE-xxxxxxx-[]--X-XXXXX
XXXXXXXXXX-XXXXXXXXXXXXXXXXXX--XXXXXXXXXXXXXXXXX-----XXXXXXXXXX--XX--XX--XXXXXXXXXXXXXXXXXXXXX-XXXXX