----------------------------------------------------------------------------------------------------
----------------------------------------------------------------------------------------------------
----------------------------------------------------------------------------------------------------
----------------------------------------------------------------------------------------------------
----------------------------------------------------------------------------------------------------
--------------------E--S---SSSSSSSSS------------SS---SS-------------SSS-----------------------------
-------------------<>-------------------------------------------------------------------------------
-x-----------------[]-------------------------------------------------------------------------------
<>-------xxxx------[]------------xxxx---------SS--------------xxxxx---------E---xxx-------------ooo-
[]------xx<>-x----SXXS----------xx--xxx-xxx---------SSS---xxxxx-XX-xSSS----<>--xx--x----------------
X>-----xx-[]--xx------xxxx-----xx------xx--xxx-----------xxXX<>-XX--x---------xx--------------------
x]x---xx--[]-<>-x----xx<>-x---xx-------<>--<>-x-xxxxx---xxXXX[]-XXX--x-------xx--------------------x
-]-xxxx---[]-[]--xxxxx-[]--xxxx--------[]--[]--xx----xxxxXXXX[]-XXX---xxxxxxxx------xxxxxxxxxxxxxxxx
XXXXXXXXXXXXXXXXXXXXXXXXXXXXXXX------XXXXXXXXX-XX-X-XXXXXXXX-XXXXXXXXXXXXXXXXX----XXXXXXXXXXXXXXXXXX