-------------------xxxxx----------------------------------------------------------------------------
xxxxxxxxxxxxxxxxxxxx----xxxxxxxxxxxxxxxxxxxxxxxxxxxxxxxxx-------------------------------------------
?SSSSSSSSSSSSSSSSSSS----SSSSSSSSSSSSSSSSSSSSSSSSSSSSSSSS-x---SSSSSSSSSSSSSSSS-------------SSS--[]SSS
------------------------SSSS------------------------------x--SSSS------------------------------[]SSS
------------------------SSSS-------------------------------x-SSSS------------------------------[]SSS
------------------------SSSS----E---------------------------xSSSS-------------xx--xxxxx--------[]SSS
-------------------------------<>----------------------------x---------------xx-xxx----x-------[]SSS
------------XXX----------------[]------------E----------------x-------------xx--XXX-----x------[]SSS
--------------------------E----[]-----------<>----------------oxxx------xxxxx------------x------]SSS
X------------------------<>---?SSS--E-------[]---------------S?SS-x----xx-XXX-------------xxxxx-]SSS
X------------------------[]--------<>-------[]--<>-----E-----SSS---x--xx-----------SSS-S--SSSSSSSSSS
X---XXX------------------[]--------[]---<>--[]--[]----<>-----SS-----xxx------------SSS-S--SSSSSSSSSS
X------------------------[]--------[]---[]--[]--[]----[]-------E-EE--xX------------SSS-S--SSSSSSSSSS
X-------------------XXXXXXXXXX----XXX---XX--XX--XX--XXXXXXXXXXX-XXXXXXX---------XXXSSS-S--XXXXXXXXXX