--------------------------------------------------
--------------------------------------------------
--------------------------------------------------
--------------------------------------------------
--------------------------------------------------
-------xx-----------------------------------------
------xx-x----------------------------------------
-----xx---x---------------------------S-----------
----xx-----x----------------------ooooS-----------
---xx-------x-------------xxxx---SSSSSS----------x
-xxxXX-------x-----------xx<>-x-----------------xx
xxXXXX--------x-------B-xx-[]--x--------------Exx-
x------------X-xxxxxxxxxx--[]---xxxxxxxxxxxxxxxx--
XXXXXXXXXXXXXXXXXXXXXXXXXXXXXXXXXXXXXXXXXXXXXXXX--