----------------------------------------------------------------------------------------------------
----------------------------------------------------------------------------------------------------
----------------------------------------------------------------------------------------------------
----------------------------------------------------------------------------------------------------
--------------------S-----xxxx------------------------------------------xxxxx---------E-------------
]------------------------xx---xSSS-------------------------------------xx?SSxSSSSSSSSSSSSS----------
x-----------------------xx-----x--xxxxxxxxxx--------------------------xx-----x----------------------
------------------E----xx-------xxxXXXXXXXX-x------------------------xx-------x---------------------
--xxx-----xxxxxxxxxxxxxx---------xXXXXXXXX---xQ---xx-----------xxxxxxx---------x------E------X------
-xx--x---xx-XXXXXXXXXXXX---------XXXX---------x--xx-x-xxxxx---xx-XXXXEXXX-------x-----QQ?QQQQX------
xx----x-xx----------------------XXXXX----------xxx---xx----x-xx------------------x------------------
x------xx----------------------XXXXXX-----------x----<>-----xx--------------------xx---------------x
X------<>-------Q-------------XXXXXX----<>-----<>----[]-----<>--------------------X-xxxxxxxxxxxxxxxx
X------[]---------------------XXXXXX----[]-----[]----[]-----[]--------------------XXXXXXXXXXXXXXXXXX