--------------------------------------------------
--------------------------------------------------
--------------------------------------------------
--------------------------------------------------
--------------------------------------------------
--------------------------------------------------
--------------------------------------------------
--------------------------------------------------
-----------<>-------------------------------------
xxx--------[]--------------------------QQQQQQQxxxx
<>-x-----------------------------------------xx--<
[]--x---------xxx------Exxx---------xxxx----xx---[
b]-E-xxxxxxxxxx--xxxxxxxx--xxxxxxxxxxEE-xxxxxX---[
XXXXXXXXXXXXXXX--XXXXXXXX--XXXXXXXXXXXXXXXXXXX---X