----------------------------------------------------------------------------------------------------
----------------------------------------------------------------------------------------------------
-------------------------------------------------------------------------------XXX------------------
----------------------------------------------------------------------------------------------------
---------------------------------------------------------xxxxx--------------------------------------
--------------------------------------------------------xxXX--x------------------------oo--XXXX-----
-------------------------------------------------------xxXXX---x----------------------XX-----------x
------------------------------------------------------xxXXXX----x-------------------------xxxxx---xx
E---xxxx---------------------------------------------xxXXXXX-----x----------------------xxx----xxxx-
---xx<>-x-------------------x--xxx------------------xxXXXXXX---S--x--------------------xxXX---XXXXX-
--xx-[]--x--------------------xxX-x----------------xxXXXXXXX-------x------------------xx------------
-xx--[]---x----xxxxx-xxx-----xx-X--x--------------xxXXXXXXXX--------xx-------xxxxx---xx-------------
xx-Q-[]----xxxxx----xx--xxxxxx--X---xxxxxxxxxxxxxxxXXXXXXXXX--------X-xxxxxxxx----xxxx--------------
XXXXXXXXXXXXXXXX-X-XXX--XXXXXXXXX--XXXXXXXXXXXXXXXXXXXXXXXXXXXXXXXXXXXXXXXXXXX----XXXX-----XXXX-----