----------------------------------------------------------------------------------------------------
----------------------------------------------------------------------------------------------------
----------------------------------------------------------------------------------------------------
----------------------------------------------------------------------------------------------------
----------------------------------------------------------------------------------------------------
---------------QQQQ------------------------------------------------------------xxx------------------
-ooooX------------------------------------------------------------------------xxX-x-----------------
-----------------------------------------------------------------------------xxXX--x----------------
xx--------------------------------------------------------------------------xxXXX---x---------xxxx--
>-x----------QQ?SSQQQ---------------------------------xxx------------------xxXXXX----x-------xx<>-x-
---x-------------------------xxxx--------------------xxX-x----------------xxXXXXX-----x-----xx-[]--x
----x----------xxx----------xx<>-x-----xxxxx-xxx----xx-X--x--------------xxXXXXXX------x---xx--[]---
-----xxxxxxxxxxx--xxxxxxxxxxx-[]--xxxxxx----xx--xxxxx--X---xxxxxxxxxxxxxxxXXXXXXX-------xxxx---[]---
XXXXXXXXXXXXXXXX--XXXXXXXXXXXXXXXXXXXXXX---XXX--XXXXXXXX--XXXXXXXXXXXXXXXXXXXXXXXXXXXXXXXXXXXXXXXXXX