----------------------------------------------------------------------------------------------------
-------------------------------------------------------------xxx------------------------------------
--------------------------------E---------------------------xx--x-----------------------------------
-----------------------------------------------------------xx----xx---------------------------------
----------------------------------------------------------xx-----E-xxxxxx---------------------------
------------------------SSSSSSSS?S--------S----S--------xxx---------x----x-------SSSSSS----------x--
Q-----------E------------[]----------------------------xx-S--------<>-----x-----------------------x-
-B---------<>------------[]---------------------------xx-----------[]------xxxx-------xxx----------x
-b---x-----[]------------[]--------------xxxx--------xx------------[]-------xB-xxxxxxxx--x----------
xxx---x--QQQQQQQQ--------[]-------------xx<>-x------xx-------X-----XX-------XXXXESSSSSS---x--------S
<>-x---x-----------------<>------------xx-[]--x----xxE---------------------XXXXXX----------x--------
[]--x---x----------------xxx----------xx--[]---x--xx<>--------------------XXXXXXX-----------x-------
[]---x---xxxxxxxxxxxxxxxxxE-xxxxxxxxxxx---[]----xxx-[]-----X-------------XXXXXXXX----------B-xxxxx--
XXXXXXXXXXXXXEEXXXXXXXXXXXXXXXXXXXXXXXXXXXXXXXXXXXXXXXXXXXXX-------------XXXXXXXXXXXXXXXEXXXXXXXXXXX