----------------------------------------------------------------------------------------------------
----------------------------------------------------------------------------------------------------
SS----------------------------------S------XXX------------------------xxxx--xxx---------------------
SS--------------------XXXXXXXXXXXX--S------[]----------------xxxxxx--xx---xxx--x--------------------
SS-------------------XX-------------S------[]---------------xxX----xxx-----<>---x-------------------
SS------------------XXX-------------S------<>--------------xxXX-----x------[]----x------------------
SS-----------------XXXX-------------S---------------------xxXXX----XX------XX-----x-----------------
SS----------------XXXXX-------------S--------------------xxXXXXXX------------------x----------------
SS---------------XXXXXX-------------S------xxx----------xxXXXXX---------------------xxxxx-----------
SS---------E----XXXXXXX-------------S-----xx--x--------xxXXXXXX----------------------xXX-x----------
SS----E---<>---XXXXXXXX-----<>------S----xx----x------xxXXXXXXX----------------------XXX--x---------
SS---<>---[]--XXXXXXXXX-----[]------S---xx------x----xxXXXXXXXX-E-------------------XXXX---x--------
SS---[]---[]-XXXXXXXXXX-----[]------Sxxxx--------xxxxxXXXXXXXXX<>-------------------XXXX----xxxxxxxx
XX---XX---XXXXXXXXXXXXXXXXXXXXXXXXXXXxXXX--------XXXXXXXXXXXXXX[]-------------------XXXXXXXXXXXXXXXX