----------------------------------------------------------------------------------------------------
----------------------------------------------------------------------------------------------------
----------------------------------------------------------------------------------------------------
----------------------------------------------------------------------------------------------------
----------------------------------------------------------------------------------------------------
----------------------------------------------------------------------------------------------------
-------------------------------------------------------------------xxxxx----------------------------
-----------------------------------xxxxx--------------------------xxXXX-x---------------------------
-----------------o--------------xxxx-<>-x------------------------xxXXX---x---------S----------------
-------------------------------xxQQ?-[]--x----------------------xxXXXX----x---------------xxx------x
---------------------------x--xx-----[]---x--------------------xxXXXXX-----x------xxx----xxX-x----xx
xx-xxx---xxx--------------xx-xx------[]----x------------------xxXXXXXX------x----xxS-x--xx-X--x--xx-
--xx--xxxx--xxxxxxxxxxxxxxx-xx--X----[]-----xxxxxxxxxxxxxxxxxxxXXXXXXX-------xxxxx-S--xxx--X---xxx--
XX-X-XXXXX-XXXXXXXXXXXXXXXXXXXXXXXXXXXXXXXXXXXXXXXXXXXXXXXXXXXXXXXXXX---XXXXXXXXXXXXXXXXXXXXXXXXXXXX