--------------------------------------------------
--------------------------------------------------
--------------------------------------------------
--------------------------------------------------
----E------------------------------------------E--
SSSSSSSS-------------------------------------SSSSS
--------------------------------------------------
--------------------------------------------E-----
----E------X--------------------------------------
----QQ?QQQQX--------------S?S-------------S?S-----
--------------------------------------------------
xx---------------xxx--------------xxxx------------
X-xxxxxxxxxxxxxxxx-Exxxxxxxxxxxxxxx---xxxxxxxxxxxx
XXXXXXXXXXXXXXXXXX--XXXXXXXXXXXXXXX---XXXXXXXXXXXX