----------------------------------------------------------------------------------------------------
----------------------------------------------------------------------------------------------------
-----------SS------------------XXXX-----------------------------[]----------------------------------
-----------[]-------------------[]------------------------------[]----------------------------------
-----------[]-------------------[]------------------------------<>-----xxx--------------------------
-----------<>-------------------[]------------------------------------xx--x-------------------------
--------------------------------[]-----------------------------------xx-E--x------------------------
x-----------E-------------------[]--------------------------------xxxx------x---E-------------------
---------xxxx-------------------[]------xxx----------------------xx--E-------x-------oo------xxx----
o-------xx<>-x-QQQQQ?QQQQQQQ?Q--<>-----xxX-x-----------------xxxxx-----------ox-------------xx--xx--
ox-----xx-[]--x-----------------------xx-X--x---------------xx-XXX-------------x-----------xx---X-x-
--x---xx--[]---x---------------------xx--X---x-------------xx--XX----------XXX--xxxxxxxxxxxx----XX-x
---xxxx---[]----xxxxxxxxxxxxxxxxxxxxxx--EX----xxxxxxxxxxxxxxX-------------------XXXX---XXXXX----XXXX
XXXXXXXXXXXXXXXXXXXXEEXXXXXEXEXXXXXXXXXXXX----XXXXXXXXXXXXXXX---------------------------X-------XXXX