--------------------------------------------------
----------------------------------------------xx--
--------------------------------------------SSSS--
--------------------------------------------------
-------------------------------xxxx---------------
----------------------xxxx----xxXX-x----------E---
---------------------xx---x--xxXXX--x--------[>---
--------------------xx-----xxxXXXX---x-------[]---
------------xxx---xxx-------xXXXXX----x------[]---
-xxx-------xxS-x-xxXX-------XXXXXX-----x----------
xx--xxx---xx----xxXXX-------XXXXXX------x--------x
<>--<>-x-xxSS-SSxXXXX-------XXXXXX-------x------xx
[]--[]--xx-SS-SSXXXXX-------XXXXXX--------xxxxxxx-
XXXXXXX-XXXXXXX-XXXXX-------XXXXXX---XXXXXXXXXXXX-