----------------------------------------------------------------------------------------------------
----------------------------------------------------------------------------------------------------
----------------------------------------------------------------------------------------------------
----------------------------------------------------------------------------------------------------
-----------------------------------------------------------------------------------ooo--------------
SSS--------SSSSS------SSSS---------------------------------------------------------ooo--------------
----------------------------------------------------------------------------------------------------
-----------------------------------------------------------xxxxxx-----oooo---------xxxx-------xxx---
---xxxx-------------------------xxxx-----------xx--xxx---xxx--x--x----oooo--------xx---xxxxxxxx--x--
--xx<>-x-QQQQ--QQQ-------------xx<>-x---------xx-xxxS-x-xxXX--X---x-------------Exx---XXXXXXEXX---x-
-xx-[]--x---------------------xx-[]--x------xxx---x----xxXXX--X----xxxxxxxxxxxxxxx----X-------X-----
xx--[]---x-----------xxxxx---xx--[]---x----xx<>-X-SS-SSxXXXX--X----XXXXXXXXXXXXXXX----X-------X---Xx
x---[]----xxxxxxxxxxxx----xxxxE--[]----xxxxx-[]XX-SS-SSXXXXX--X----X-------------X----X-------X---XE
XXXXXXXXXXXXXXXXXXXXXX----XXXXXXXXXX---XXXXXXXXXXXXXXX-XXXXX--X----X-------------X----X-------X---X-