------------------xxx------------------xx-----------------------------------------------------------
-----------------xx--x-------xxx------xx-xxxxxxxxxxxxxxxxxxxx-xxx-----------------------------------
----------------xx----x-----xx--x----xx--SSSSSSSSSSSSSSSSSSSSSSS-x------------------------SSSSSSSSSS
---------------xx------x---xx----x--xx----------------------------x-----xxx-------------------------
-------xxxxxxxxxE-------x-xx------xxx------------------------------x--xxx--x------------------------
------xx---x---<>--------xx-------XXX-------------------------------xxxXS---x-----------------------
-----xx-E--E---[]--------XX------------------------------------------xEX-----x----------------------
---xxx---------[]------------------------o---------------------------XXX------x---------------------
--xx-E---------[]------------------------S---------E----------------XXXXS------x--------------------
-xx------------[]-----------------------------E---<>---------------XXXXX--------x---------B--------x
xx-------------[]----------------------------<>---[]---<>---------XXXXXX---------x--------b-------xx
x--------------[]----------------------------[]---[]---[]-----B---XXXXXX----------x-------B---?--xx-
X--------------[]----------------o---o-------[]---[]---[]----xb---XXXXXX---------X-xxxxxxxxxxxxxxx--
X--------------XX-XXX------------X---X-------[]---[]---[]-----xXXXXXXXXXXXXXXXXX-XXXXXXXXXXXXXXXXX--