--------------------------------------------------
-----------------------xxx------------------------
----------------------xx--x-----------------------
---------------------xx----xx---------------------
--------------------xx-----E-xxxxxx---------------
----S----S--------xxx---------x----x-------SSSSSSS
-----------------xx-S--------<>-----x-------------
----------------xx-----------[]------xxxx--------x
---xxxx--------xx------------[]-------xB-xxxxxxxxx
--xx<>-x------xx-------X-----XX-------XXXXESSSSSSS
-xx-[]--x----xxE---------------------XXXXXX-------
xx--[]---x--xx<>--------------------XXXXXXX-------
x---[]----xxx-[]-----X-------------XXXXXXXX-------
XXXXXXXXXXXXXXXXXXXXXX-------------XXXXXXXXXXXXXXX