----------------------------------------------------------------------------------------------------
----------------------------------------------------------------------------------------------------
----------------------------------------------------------------------------------------------------
-------------------XXX----------------------------------------------------------------------XXXXXXXX
-------------------------------------------------------------------------------------------XX-------
E-----------------------------------------------------------------------------------------XXX-------
>----------------------------------------------------------------------------------------XXXX-------
]---------------------------------------------------------------------------------------XXXXX-------
X--------------------------E--------------X-----X--------------------------------------XXXXXX-------
X---------------------QQQQQQQ----------X-------------E--EE----------------------------XXXXXXX-------
X------------XXXXXXXXX-----------------X------------<>--<>--------E----E-------------XXXXXXXX-----<>
X-------------------------------<>-----X------------[]--[]--------------------------XXXXXXXXX-----[]
X-------E-----------------------[]-----X-----XX-----[]--[]-------------------------XXXXXXXXXX-----[]
XXXXXXXXXXXXXXXXXXXXXXXX-XXXX---XXXXXXXX----XX------[]--[]------------------------XXXXXXXXXXXXXXXXXX