-----------------------x--------------------------
--------------------------------------------------
<SSS-----SSSSS------------------------------S-----
--------------------------------------------------
----xxx-------------------------------------------
X--xx--x-------------------------------------xxx--
--xx----x----xxxxxxxxxx----------------------x--xx
-xx------x--xxXXXXXXXX-x--------------------xx--XX
xx--------xxxXXXXXXXX---x----xx---------xxxxx-----
SX---------xXXQX---------x--xx-x-xxx---xx-XXX-----
SS---------XXXXX----------xxx---xx--x-xx----------
SS--------XXXXXX-----------x----<>---xx-----------
SS-------XXXXXXX---<>-----<>----[]---<>-----------
XX-------XXXXXXX---[]-----[]----[]---[]---------XX