-------------------------------------------------------------------o--------------------------------
------------------------------------------------------------------------xxxxxxxxxxxxxxxxxxxxxxxxxx--
---------------------------------------------------------------SSSSSSSSSSSSSSSSSSSSSSSSSSSSSSSSSS-x-
---------------------------------------------------------------------------------------------------x
--------------------------------------------------xxxx----------------------------------------------
-----------------xxxxx---------------------------xxXX-x------------------E--------------------------
----------------xx-<>-x-------------------------xxXXX--x----------------<>--------------------------
o--------------xx--[]--x-----------------------xxXXXX---x---------------[]------------E-------------
-------------xxx---[]---x---------------------xxXXXXX----x--------------[]-----------<>-------------
------------xx<>--QQQ?---x-------------------xxXXXXXX-----x------------?SSS--E-------[]-------------
-----------xx-[]----------x--------xxxx-----xxXXXXXXX------x----------------<>-------[]--<>-----E---
----------xx--[]-----------x------xx<>-x---xxXXXXXXXX-------x---------------[]---<>--[]--[]----<>---
xxxxxxxxxxx---[]------E-----xxxxxxx-[]--xxxxXXXXXXXXX--------xxxxxxxxx------[]---[]--[]--[]----[]---
XXXXXXXXXXXXXXXXX-----X---XXXXXXXXXXXXX-XXXXXXXXXXXXXXXXXXXXXXXXXXXX-------XXX---XX--XX--XX--XXXXXXX