----------------------------------------------------------------------------------------------------
----------------------------------------------------------------------------------------------------
SSSSSSSSSSSSSSSSSSSSSSSSSSSSSSS?SSSSSSSSSSSSSSSSSSSSSSSSSSSSSSSSSSSSSS-------------SSS--[]SSSSSSSSSS
SSSSSSSSSSS------SSSS-------------------------------------------------------------------[]SSSSSSSSSS
SSSSSSSSSSS--E---SSSS-------------------------------------------------------------------[]SSSSSSSSSS
SSSSSSSSSSS--SS----------ooooooo---------------------------------------xx--xxxxx--------[]SSSSSSSSSS
--------S----SS-------------------------------------------------------xx-xxx----x-------[]SSSSSSSSSS
x-------S----SS----------SSSSSSS-------------------------------------xx--XXX-----x------[]SSSSSSSSSS
-x------So??-SS---E------SSSSSSS---------------------------------xxxxx------------x------]SSSSSSSSSS
--xx----SSS--SS--SSSS-------------------------------------------xx-XXX-------------xxxxx-]SSSSSSSSSS
----x-----------EE---------------------------->-----XX---------xx-----------SSS-S--SSSSSSSSSSSSSSSSS
o----x--------------xxxxx---------------QQQ------?-QX---xxx---xx------------SSS-S--SSSSSSSSSSSSSSSSS
o-xEX-xxxxxxxxxxxxxxx----xxxxxxxxxxxxxxxxxxxxxxxxxxxxxxxx--xxxx-------------SSS-S--SSSSSSSSSSSSSSSSS
X-XEXXXXXXXXXXXXXXXXX---XXXXXXXXXXXXXXXXXXXXXXXXXXXXXXXXX--XXXX----------XXXSSS-S--XXXXXXXXXXXXXXXXX