----------------------------------------------------------------------------------------------------
-----E----------------------------------------------------------------------------------------------
SSSSSSSSSSSSSSSSSSSSSSSSSSSSSSSSS?SSSSSSSSSSSSSSSSSSSSSSSSSSSSSSSSSSSSSSSSSSSSSSSSSSS---------------
---[---S-----------------------------------------------------SS-SSSSSSS-----------------------------
---[---S-----------------------------------------------------SS-SSSSSSSE----------------------------
---[------------------------oooooo------------------------S-S-------SSSSS---?-----------------------
---[------------------------------------------------------S-S-------SS-S----------------------------
---[--------------o---------SSSSSS------------------------SSS---S---SS-S----------------------------
--->------xxxx--------------SSSSSS------------------------SSS---SoooSS-S----------------------------
x--]--SS-xx<>-xSSS------------------QQQ--------QQQQQ------SSSSS--SSSS---------------X-----xxx-----S-
S-SS--S-xx-[]--x---------------------------------------------SS-----------E--------XX----xxX-x------
S-SS--Sxx--[]---x------xxxx----------------------xxx---------SS--------------xxxx-XXX--Exx-X--x-----
xxxxxxxx---[]----xxxxxxx---xxxxxxxxxxxxxxxxxxxxxxx--xxxxxxxxxxxxxxxxxxxxxxxxxx---xxxxxxxx--X---xxxxx
XXXXXXXXXXXXXXXXXXXXXXXX--XXXXXXXXXXXXXXXXXXXXXXXX--XXXXXXXXXXXXXXXXXXXXXXXXXX---XXXXXXXX--XXXXXXXXX