----------------------------------------------------------------------------------------------------
----------------------------------------------------------------------------------------------------
--------------------------------------------------oo-------xxx--------------------------------------
----------------------------------------------------xxxxxxxx--x-------------------------------------
---------------------------------------Eooo--------xxXXXXXXX---x------------------------------------
--------XX-----------------------------XXXXX------xx------------x-------------E------------SSSSSSSSS
--------XX---------------------------------------xx------------oox---------SSSSSSSSSSSSSS-----------
----xxx-XX----------------------------------xxxxxx----------------x---------------------------------
---xxXx-XX--------------------------xxxxxxxxx---XXXXX--------------x---------------xxxx-------E---E-
--xxXX--XX-------------------------xxXXXXXXXX-----------------------x-------------xx<>-x------SSSSSS
Exx-XX-xXX------------------------xx---------------------------------x-----------xx-[]--x-----------
xxX-XX--x--------xxx--------xxxxxxx-----------o-----------------------x---------xx--[]---x-------xxx
xXX-XX---xxxxxxxxxX-xxxxxxxxx--XXXX----------XXX-----------------------xxxxxxxxxx---[]----xxxxxxxx--
XXXXXXXXXXXXXXXXXXXXXXXXXXXXX----------------------------------XXXX---XXXXXXXXXXXXXXXXXXXXXXXXXXXX--