----------------------------------------------------------------------------------------------------
----------------------------------------------------------------------------------------------------
SSSSSSSSSSSSSSSSSSSSSSSSSSSSSS?SSSSSSSSSSSSSSSSSSSSSSSSSSSSSSSSSSSSSSSSSSSSSSSS---------------------
]SSS--SSSS------SSSS--------------------------------------------------------------------------------
]SSS--SSSS--E---SSSS-------------------------------------------------------------XXX----------------
]SSS---S----SS----------ooooooo------------------------------------------------------------------XXX
QSSS---S----SS---------------------------------xx---------------------------------------------------
SSSS---S----SS----------SSSSSSS---------------xx-x-xxx----------------------------------------------
SSSS---So??-SS---E------SSSSSSS--------------xx---xx--x---------------------xxxxx-----SSSSSS??------
S------SSS--SS--SSSS-----------------------xxx----<>---x------xxxx---------xxXXX-xxxx---------------
---------------EE-------------------------xx<>----[]----xxx--xxSS-x-------xxEXXX-XXX-x--------------
-------------------xxxxx-----------------xx-[]----[]----<>-xxx-SS--x-----xxXXXXX------x-------xxx---
xxxxxxxxxxxxxxxxxxxx----xxxxxxxxxxxxxxxxxx--[]----[]--E-[]--x--SS---xxxxxxXXXXXX-------xxxxxxxx--xxx
XXXXXXXXXXXXXXXXXXXX---XXXXXXXXXXXXXXXXXXXXXXXXXXXXXXXXXXXXXX--XX--XXXXXXXXXXXX-------XXXXXXXXX--XXX