----------------------------------------------------------------------------------------------------
----------------------------------------------------------------------------------------------------
SSSSSSSSSSSSSSSSSSSSSS--[]S-------------------------------------------------------------------------
------------------------[]--------------------------------------------------------------------------
------------------------XXXX------------------------------------xxxxxxxxxxx----------E-E------------
----------------------------------------XXX--------------------xx--QQQ?QQQ-x-------SSSSSSS-SS-xxxx--
--------------------------------------------------------------xx------------x-------------E--xx---x-
-------------------------------------------------------------xx------E-------x--------------xx-----x
-------------------xxxxx------SSSSS??----------------------xxx-----SSSSSSS----x-----------xxx-------
-----xxxx---------xxXXX-xxxxx-----------------------------xx<>--------------E--x---------xx<>-------
----xxSS-x-------xxEXXX-XXXX-x---------------------------xx-[]-------X------X---x---E---xx-[]-------
x-Exx-SS--x-----xxXXXXX-------x------xxx---------xxx----xx--[]-------X------X----x-----xx--[]-------
-xxx--SS---xxxxxxXXXXXX--------xxxxxxx--xxxxxxxxxx--x-xxx---[]----E--X------X-----xxxxxx---[]-------
XXXX--XX--XXXXXXXXXXXX--------XXXXXXXX--XXXXXXXXXX---xXXXXXXXXXXXXXXXXXXXXXXXXXXXXXXXXXXXXXXX-------