----------------------------------------------------------------------------------------------------
----------------------------------------------------------------------------------------------------
-------------------------------------------------------------------------------oo-------------------
----------------------------------------------------------------------------------------------------
---------------------------------------------xxxxx--------------------------------------xxx---------
--SSSSSS---------E-xxxxx------------------E-xxXXX-x----------------------------XXX-----xx--x--------
------------------x<>XX-x------------------xxXXXX--x----------------------------------xx----x-------
-----------------xx[]XX--x----------------xxXXXXX---x--------------------------------xx------x------
---------------xxxXXXXX---x-xx----------xxxXXXXXX----x---------------------------xxxxx--------xxxx--
SS----xxxx---xxx<>XXXXX----xx-x--------xx<>XXXXXX-----x-----------------XXXX----xxXXXX---------<>-x-
-----xx---x-xxxX[]XXXXX-X--<>--x------xx-[]XXXXXX------x-----------------------xx--------------[]--x
x---xx-----xxXXX[]XXXXXXX<>[]---x----xx-X[]XXXXXX-------xxx-------xxx---xxx---xx---------------[]-<>
-xxxx------XXXXX[]XXXXXXX[][]----xxxxx-XX[]XXXXXX-------XX-xxxxxxxx--xxxx--xxxx----------------[]-[]
XXXXX------XXXXXXXXXXXXXXXXXXXXXXXXXXXXXXXXXXXXXXXXXXXXXXXXXXXXXXXX--XXXX--XXXX--------XXXXX-XXXXXXX