--------------------------------------------------
xx------------------------------------------------
SSS-----------------------------------------------
]-------------------------------------------------
]-------------------------------------------------
]-------------------------------------------------
]-x---------X--EX---------------------------------
]-----------X---X---------------------------------
>-----X---X-X---X--------X-EE----X-------------ooo
]-S---XSSSX-XSS?X--------XSSSSSSSX-------------ooo
]-S-----------------------------------------------
]-S------------------xxx--------------------------
]-Sxxxxxxxxxxxxxxxxxxx--xxxxxxxxxxxxxxxxxxxxxxxxxx
XXSXXXXXXXXXXXXXXXXXXX--XXXXXXXXXXXXEEXEXXXXXXXXXX