----------------------------------------------------------------------------------------------------
----------------------------------------------------------------------------------------------------
----------------------------------------------------------------------------------------------------
----------------------------------------------------------------------------------------------------
-----------------xxxx--------------------ooooooooo--E---xxxxxxx---------E---------------------------
----------------xx---x------------------SSSSSSSSSSSSSSSxx-SSSSxSSSSSSSSSSSSS------------------------
---------------xx-----x-------------------------------xx-------x------------------------------------
--------------xx-------x-----------------------------xx---------x-----------------------------------
------------xxx--S------xx-------------xxxxxxxxxxxxxxx-----------x------E------X--------------------
--S--------xx<>--------S?-xx----------xx-?SSSSSSSSSSSS--X?--------x-----QQ?QQQQX--------------------
E---------xx-[]--------SS-S-x--------xx----------------XX----------x--------------------------------
--xxxxx--xx--[]--------SS-S-Sx------xx----------------XXX-----------xx---------------xxx------------
xxx----xxx---[]--S-----SSxS-S-xxxxxxx-----------E----XXXX-----------X-xxxxxxxxxxxxxxxx-Exxxxxxxxxxxx
XXX----XXXXXXXXXX-XXXXXXXXXXXXXXXXXXX---XXXXXXXXXXXXXXXXXXXXX-------XXXXXXXXXXXXXXXXXX--XXXXXXXXXXXX