----------------------------------------------------------------------------------------------------
-----------------------------------------------------------------------------------------xx-------xx
----------------------------------------------------------------------------------------xx-x-----xx-
---------------------------------------------------------------------------------------xx---x---xx--
---------------------------------------------------------------------------------xxxxxxx-----x-xx---
---------------------------------------------------------------x------xxxxS-----xxXXXXXX------xx----
---------------------------------------------------------------------xx--xxx---xx-------------XX----
--------------------------------------------------------------------xx------x-xx--------------------
--------------------------E----------------------------------------xx----E-EExx---------------------
o------------------------<>-----x--------------E--S---------------xxX--------XXXX------XX-----------
----------------------------------------------<>---------E-------xxXXX-------XXX--------------------
-xxxxx------Exxx------------------xxxxx-----------------<>--->--xxXXXX-------XX---------------------
xx----xxxxxxxx--xxxxxxxxxxxxxxxxxxx----xxxxxxxxxxxxxxxxxxxxxxxxxxXXXX--------X----------------------
XX----XXXXXXXX--XXXXXXXXXXXXXXXXXXX---XXXXXXXXXXXXXXXXXXXXXXXXXXXXXXX--------X----------------------