----------------------------------------------------------------------------------------------------
----------------------------------------------------------------------------------------------------
--------------------------------------------------------------SSS--[]SSSSSSSSSSSSSSS----SS----------
-------------------------------------------------------------------[]SSSSSSSSSSSSSSS----SS----------
-------------------------------------------------------------------[]SSSSSSSSSSSSSSS----SS----------
---------------------QQQQQ------------------------------xxx--------[]SSSSSSSSSSSSSSS----SS----------
-------------------------------------------------------xx--x-------[]SSSSSSSSSSSSSSS----SS----------
------------------------------------------------------xx----x------[]SSSSSSSSSSSSSSS----SS----------
-------------xxxx------------------------------------xx------x------]SSSSSSSSSSSSSSS----SS----------
------------xx<>-x--E?QQQQ----------E--S------------xxX-------xxxxxx]SSSSSSSSSSSSSSS----SS-S--------
x----------xx-[]--x----------------<>---------E----xxXXX---S--SSSSSSSSSSSSSSSSSSSSSS----SS-S--------
-x--------xx--[]---x-------------------------<>---xxXXXX---S--SSSSSSSSSSSSSSSSSSSSSS----SS-S-----B--
-Exxxxxxxxx---[]----xxxxxxxxxxxxxxxxxxxxxxxxxxxxxxxXXXX----S--SSSSSSSSSSSSSSSSSSSSSS----SSxxx----b--
XXXXXXXXXXXXXXXXXXXXXXXXXXXXXXXXXXXXXXXXXXXXXXXXXXXXXXX----S--XXXXXXXXXXXXXXXXXXXXXXxxxxxxx--xxxxxxx