----------------------------------------------------------------------------------------------------
-----------------------------------------------------------------xx---------------------------------
----------------------------------------------------------------xx-x--------------------------------
---------------------------------------------------------------xx---x-------------------------------
--------------------------------------------------------------xx-----x------------------------------
--------SSS------------------------------SSSSS---?-------xxx--xS------x-----------------------------
--------------------------------------------------------xx--x-x--------x----------------------------
-------------------------------------------------------xx----xx---------x---------------------------
------xxxxxxx-----------------------------------------xx------x----------x------------Q--?----------
--E--xxXXXXX-x---------------xxx------S---E---------xxx-------SS---X------x--------Q-E------ESSS----
--E-xx-X------x-------------xxX-x--------------E---xx<>------------X-------x---------E-------------<
---xx--X-------x----------Exx-X--x----------------xx-[]------------X--------x-----------------------
xxxx---X--------xxxxxxxxxxxx--X---xxxxxxxxxxxxxxxxx--[]E-----------X-------X-xxxxxxxxxxxxxxxxxxxxxxx
XXXXXXXXXX----XXXXXXXXXXXXXX--XXXXXXXXXXXXXXXXXXXXXXXXXXXXXXXXXXXXXXXXXXXXXXXXXXXXXXXXXXXXXXXXXXXXXX