----------------------------------------------------------------------------------------------------
----------------------------------------------------------------------------------------------------
----------------------------------------------------------------------------------------------------
------------------------------------------------------------------------------x---------------------
-----------------------------------------------------------------------xxxxxx-----------------------
----------------------------------------------------------------------xx?SSS-x-----------S----S-----
SSSSS---------xxx--------------ES---------------E---------------------x-------x---------------------
--------------xB-x------S-------------QQQ------<>----------------xxxxxx--------x--------------------
--xxxx-------xxb-------------------------------[]---------------xx---xE-------E-x-------xxxx--------
-xx--xxx----xxXXX-xS------------------------QQQQQQQQQQ---------xx----<>---E--<>--x-----xx<>-x------x
xx------x--xxXXXX--x-----xxx---------------------------------xxx-----[]--<>--[]---x---xx-[]--x----xx
x--------xxxXXXXX---x---xxB-x-----------xxxxx---------------xx<>-----[]--[]--[]----x-xx--[]---x--xx<
----------xXXXXXX----xxxx-b--xxxxxxxxxxxxB---xxxxxxxxxxxxxxxx-[]--E--[]--[]--[]-----xx---[]----xxx-[
X-----S---XXXXXXXXXXXXXXXXXXXXXXXXXXXXXXXX--XXXXXE?-XXXXXXXXXXXXXXXXXXXXXXXXXXXXXXXXXXXXXXXXXXXXXXXX