----------------------------------------------------------------------------------------------------
----------------------------------------------------------------------------------------------------
----------------------------------------------------------------------------------------------------
----------------------------------------------------------------------------------------------------
----------------------------------------------------------------------------------------------------
SSS--------SSSSS------------------------------------------------------------------------------------
----------------------------------------------------------------------------------------------------
----------------------------------------------------------------------------------------------------
---xxxx------------------------------E----------------------------------S----------------xxxx-------
--xx<>-x-QQQQ--QQQ?QQ--ESSS----E----<>-----------------------------------------xxx------xx<>-x------
xxx-[]--x---------------------<>-----------------------------xxxx------xxx----xxX-x----xx-[]--x-X---
-x--[]---x-------------------------------xxxxx--------------xx<>-x----xxS-x--xx-X--x--xx--[]---x----
x---[]----xxxxxxxxxxxxxxxxxxxxxxxxxxxxxxxx----xxxxxxxxxxxxxxx-[]--xxxxx-S--xxx--X---xxx---[]----xxxx
XXXXXXXXXXXXXXXXXXXXXXXXXXXXXXXXXXXXXXXXXX---XXXXXXXXXXXXXXXXXXXXXXX<>XXXXXXXXXXXXXXXXXXXXXXXXXXXXXX