----------------------------------------------------------------------------------------------------
------------------------------------------------------------------------------------------------xx--
-----------------------------------------------------------------------------------------------xx-xx
----------------------------------------------------------------------------------------------xx--XX
-------------------------------xxxxxx--------------------------------------------------------xx---XX
---xx-------------------------xx?SSS-x----------------------------------SSSSS---?-------xxx--xS---XX
--xx-x------------------------x-------x------------------------------------------------xx--x-x----XX
-xx---x------------------xxxxxx--------x----------------------------------------------xx----xx----XX
xx-----x---xxx----------xx---xE-------E-x--------------------------------------------xx------x----XX
x-------x-xxX-x--------xx----<>---E--<>--x-------------------xxx-----S---E---------xxx-------SS---XX
---------xx----x-----xxx-----[]--<>--[]---x-----------------xxX-x-------------E---xx<>------------XX
X--------XX-----x---xx<>-----[]--[]--[]----x-xxxxx--------Exx-X--x---------------xx-[]------------XX
XX-------XXX-----xxxx-[]--E--[]--[]--[]-----xx----xxxxxxxxxx--X---xxxxxxxxxxxxxxxx--[]E-----------XX
XX-------XXXXX---XXXXXXXXXXXXXXXXXXXXXXXXXXXXX---XXXXXXXXXXX--XXXXXXXXXXXXXXXXXXXXXXXXXXXXXXXXXXXXXX