--------------------------------------------------
--------------------------------------------------
SSSSSSSSSSSSSS-----SSSSSSSSSSSS-------------------
--------------------------------------------------
--------------------------------------------------
-------------E--------------------------xxxx------
------------<>-------------------------xxXXXxx----
------------[]------------------------xxXXXXX-x--x
------------[]---xxx--------------xxxxxXXXXX---x--
---xxxx-----[]--xx--x------xxxxxxxx--XXXXXXX----x-
--xxSS-x-------xx----xxx--xxSSSSS<>--XXXXXXX<>---x
xxx-SS--x-----xx-----<>-xxx-SSSSS[]--XXXXXXX[]----
-x--SS---xxxxxx------[]--x--SSSSX[]--XXXXXXX[]----
XX--XX--XXXXXXX----XXXXXXX--XXXX-XXXXXXXXXXXXXXXXX