----------------------------------------------------------------------------------------------------
----------------------------------------------------------------------------------------------------
SS-SSSSSSSSSSSSSSS?SSSSSSSSSSSSSSSSSSSSSSSSSSSSSSSSSSSSSSSSSSSSSSSSS--------------------------------
-----SSSS-------------------------------------------------------------------------------------------
-----SSSS-------------------------------------------------------------XXX---------------------------
----x--------oooooo------------------------------------------------------------------XXX------------
----S-------------------------------xx--------------------------------------------------------------
----S--------SSSSSS----------------xx-x-xxx---------------------------------------------------------
----S-E------SSSSSS---------------xx---xx--x---------------------xxxxx-----SSSSS??------------------
----SSSSS-----------------------xxx----<>---x------xxxx---------xxXXX-xxxx--------------------------
-------------------------------xx<>----[]----xxx--xxSS-x-------xxEXXX-XXX-x-------------------------
Q?---E--xxxxx-----------------xx-[]----[]----<>-xxx-SS--x-----xxXXXXX------x------xxx---------xxxx--
xxxxxxxxx----xxxxxxxxxxxxxxxxxx--[]----[]--E-[]--x--SS---xxxxxxXXXXXX-------xxxxxxx--xxxxxxxxxx--Exx
XXXXXXXXX---XXXXXXXXXXXXXXXXXXXXXXXXXXXXXXXXXXXXXX--XX--XXXXXXXXXXXX-------XXXXXXXX--XXXXXXXXXX---XX