----------------------------------------------------------------------------------------------------
----------------------------------------------------------------------------------------------------
------------------------------------SSSSSSSSSSSSSSSSSSSSSSSSSSSSSSSSSSSSSS?SSSSSSSSSSSSSSSSSSSSSSSSS
------------------------------------[]--------SS--SSSS------SSSSS-----------------------------------
------------------------------------[]--------SS--SSSS--E---SSSSS-----------------------------------
------------------------------------[]--------SS---S----SS-----------oooooo-------------------------
-----ES--------------E-------------S[]--------SS---S----SS--------------------------------xx--------
-----------QQQ------<>--------------[]--------SS---S----SS-----------SSSSSS--------------xx-x-xxxx--
--------------------[]--------------[]----ooooSS---So??-SS---E-------SSSSSS-------------xx---xxSS-x-
-----------------QQQQQQQQQQ---------[]----SSSSSS---SSS--SS--SSSSS---------------------xxx----<>----x
xx----------------------------------<>---------------------EE------------------------xx<]----[]-----
B-x----------xxxxx------------------xxx-------------------------xxxxx---------------xx-[]----[]-----
b--xxxxxxxxxxxB---xxxxxxxxxxxxxxxxxxxE-xxxxxxxxxxxxxxxxxxxxxxxxxx----xxxxxxxxxxxxxxxx--[]----[]---E-
XXXXXXXXXXXXXXX--XXXXXEEXXXXXXXXXXXXXXXXXXXXXXXXXXXXXXXXXXXXXXXXX---XXXXXXXXXXXXXXXXXXXXXXXXXXXXXXXX