----------------------------------------------------------------------------------------------------
----------------------------------------------------------------------------------------------------
----------------------------------------------------------------------------------------------------
----------------------------------------------------------------------------------------------------
--------------------------------------------------------------------------------------xxxxxxxxxxx---
--------------------------SSSSSSSSSSSSS--------------------SSS?SSS-------QQ?---------xx--QQQ?QQQ-x--
------------------------------------------------------------------------------------xx------------x-
------------------------------xxxxxxx-----<>---------------------------------------xx------E-------x
----------S-----------------xxxSSSSS-x----[]-----------------------------SSS-----xxx-----SSSSSSS----
xxxx-------------xxx------xxxSS-------x--QQQQQQ------------SSSSSSS------xxxx----xx<>--------------E-
x---x----xxx----xxX-x----xx<>----------x-------------------------------xx---x--xx-[]-------X------X-
[-------xxS-x--xx-X--x--xx-[]-----------x-xxxxx---xxx----------xxxxxxxxx-----xxx--[]-------X------X-
X----xxxx-S--xxx--X---xxx--[]----E---EE--xx----xxxxE-xxxxxxxxxxx---x--x-------x---[]----E--X------X-
X---->XXXXXXXXXXXXXXXXXXXXXXXXXXXXXXXXXXXXX-X-XXXXXXXXXXXXXXXXXX-X-X--X-------XXXXXXXXXXXXXXXXXXXXXX