----------------------------------------------------------------------------------------------------
------------------------------------------------------------------------------xx--------------------
-----------------------------------------------------------------oo----------xx-x---SSSSSSSSSSSSSSSS
----------------------------------------------------------------------------xx---x--SSSSSSSSSSS-----
--------------------------------xxxxx-------------------------------------xxx-----x-SSSSSSSSSSS-----
-------xxxxx-----------------E-xxXXX-x---------------------------XXX-----xx--------xSSSSSSSSSS--xx-x
------xx-<>-x-----------------xxXXXX--x---------------------------------xx----------x----------xx-x-
-----xx--[]--x---------------xxXXXXX---x-------------------------------xx------------x--------xx----
---xxx---[]---x------------xxxXXXXXX----x--------------------------xxxxx----E--------oxxxxxxxxx-----
--xx<>--QQQ?---x----------xx<>XXXXXX-----x-----------------XXXX---xxXXXX---<>-------S?SSSSoXXXX-----
-xx-[]----------x--------xx-[]XXXXXX------x----------------------xx--------[]---E---SS--------------
xx--[]-----------x------xx-X[]XXXXXXX------xxx-------xxx---xxx--xx---------[]--<>---SS-------------<
x---[]------E-----xxxxxxx-XX[]XXXXXXX------XX-xxxxxxxx--xxxx--xxx----------[]--[]-----E------------[
XXXXXXX-----X---XXXXXXXXXXXXXXXXXXXXXXXXXXXXXXXXXXXXXX--XXXX--XXX--------XXXXXXXXXXXXX-XXXXXXXXX---X