------------------------------------------------------------------------xxxxxx----------------------
---------------------------------------xxxxxxxxxxxxxxxxxxxxxxxxxxxxxxxxxx-XXX-xxxxxxxxxxxxxxxxxxxxxx
SSSSSSSSSSSSSSSSSSSSSSSSSSSSSS--------xxSSSSSSSSSSSSSSSSSSSSSSSSSSSSSSSSS-----SSSSSSSSSSSSSSSSSSSSSS
SSSSSSSSSSSSSSSSSSSSS----------------xx---------------------------------------SSSSSSSSSSSSSSSS------
SSSSSSSSSSSSSSSSSSSSS-----------XXX-xx----------------------------------------SSSSSSSSSSSSSSSS------
SSSSSSSSSSSSSSSSSSSSS--QQ------xxxx-xSSS------------E-------------------------SSSSSSSSSSSSSSSS-----E
------------------------------xx---xx--------------<>-------------------------S-------------------<>
xxx-----------------xxx-xxx--xx-----xS-------------[]-------------------------S-------------------[]
x?-xxxxxxxxxxxxxxxxxx--xx--xxx------S-S------------[]------S-------------------?oooooooooo--------[]
???SSSSSSSSSSSSSSSSSS--QQ--QQQ---------S------E--SS[]S---E----E----------------??SSSSSSSSS----XX--[]
---SSSSSSSSSSSSSSSSSS------------------------<>----[]---<>---<>---------XX-------------------XXX--[]
---SSSSSSSSSSSSSSSSSS------------------------[]----[]---[]---[]--------XXXXXX---------------XXXX--[]
oooSSSSSSSSSSSSSSSSSS------------------------[]-E--[]---[]---[]-------XXXX------------EE---XXXXX--[]
XXXXXXXXXXXXXXXXXXXXXXXXXXXXXX------XXXXXXXXXXXXXXXXXXXXXXXXXXXXXXXXXXXXX-----XXXXXXXXXXXXXXXXXXXXXX