----------------------------------------------------------------------------------------------------
----------------------------------------------------------------------------------------------------
SSSSSSSSSSSSSSSSSSSSSSSSSSSSSSSSS?SSSSSSSSSSSSSSSSSSSSSSSSSSSSSSSSSSSSSSSSSS-------------SSSSSSSSSSS
SSSSSSSSSSSSSS------SSSS----------------------------------------------------------------------------
SSSSSSSSSSSSSS--E---SSSS------------------------------------------------------XXX-------------------
SSSSSSSSSSSSSS--SS----------oooooo--------------------------------------------------------------xxxx
------S----S----SS---------------------------------------------------------------------E-------xx---
------S----S----SS----------SSSSSS--------------xxx-------------------------------------------xx----
x-----So??-So??-SS---E------SSSSSS------------xxx--x---------------------xxxxx-----SSSSSS---xxx-----
-x----SSS--SSS--SS--SSSS--------------------xxx<>---x------xxxx---------xxXXX-xxxx---------xx<>-----
--x----------------EE----------------------xx<>[]----xxx--xxSS-x-------xxEXXX-XXX-x-------xx-[]-----
<>-x-------------------xxxxx--------------xx-[][]----<>-xxx-SS--x-----xxXXXXX------x-----xx--[]----<
]]--xxxxxxxxxxxxxxxxxxxx----xxxxxxxxxxxxxxx--[][]--E-[]--x--SS---xxxxxxXXXXXX-------xxxxxx---[]----[
XXXXXXXXXXXXXXXXXXXXXXXX---XXXXXXXXXXXXXXXXXXXXXXXXXXXXXXX--XX--XXXXXXXXXXXX-------XXXXXXXXXXXXXXXXX