----------------------------------------------------------------------------------------------------
----------------------------------------------------------------------------------------------------
SSSSSSSSSSSS?SSSSSSSSSSSSSSSSSSSSSSSSSSSSSSSSSSSSSSSSSSSSSS?SSSSSSSSSSSSSSSSSSSSSSSSSSSSSSSSSSSSSSSS
------------------------S---SSSSSS--SSSS------SSSS--------------------------------------------------
------------------------S---SSSSSS--SSSS--E---SSSS--------------------------------------------------
------ooooooo-------------------SS---S----SS----------oooooo----------------------------------------
S-------------------------------SS---S----SS--------------------------------xx----------------------
S-----SSSSSSS-------------------SS---S----SS----------SSSSSS---------------xx-x-xxx-----------------
S-----SSSSSSS---------------ooooSS---So??-SS---E------SSSSSS--------------xx---xx--x----------------
S----------------------SS---SSSSSS---SSS--SS--SSSS----------------------xxx----<>---x------xxxx-----
-----------------------SS--------------------EE------------------------xx<>----[]----xxx--xxSS-x----
xxxxxx-----------------SS------------------------xxxxx----------------xx-[]----[]----<>-xxx-SS--x---
x-----xxxxxxxxxxxxxxxxxxxxxxxxxxxxxxxxxxxxxxxxxxxx----xxxxxxxxxxxxxxxxx--[]----[]--E-[]--x--SS---xxx
X----XXXXXXXXXXXXXXXXXXXXXXXXXXXXXXXXXXXXXXXXXXXXX---XXXXXXXXXXXXXXXXXXXXXXXXXXXXXXXXXXXXX--XX--XXXX