--------------------------------------------------
--------------------------------------------------
--------------------------------------------------
----------------------------------E---------------
--------------------------------------------------
----------------------------XXXXXEXXXXX-----------
--------XX----------------------------------------
-------XXX-------------------xxxxx----------------
------XXXX---------------xxxxx----xxxxxxxx--------
E----XXXXX--------------xxXXXXEXEEXXXXXXX-x-------
>---XXXXXX------------xxx------------------x------
]--XXXXXXX-----------xxXXX------------------x----x
]-XXXXXXXX---------xxx-----------------------xxxxx
XXXXXXXXXX--------XXXXXXXX--------------XXXXXXXXXX