----------------------------------------------------------------------------------------------------
----------------------------------------------------------------------------------------------------
----------------------------------------------------------------------------------------------------
----------------------------------------------------------------------------------------------------
----------------------------------------------------------------------------------------------------
Q-----------------------------------------xxx---------------------------------------------E-E-E-----
-----------------------------------------xxX-x-------------------------------------------<><><>-----
----------------------------------------xxXX--x--------------xxxxx-----------------------[][][]-----
------------------xx-------------------xxXXX---x----------xxxx-<>-x------------------Q?--QQQQQQ-----
-----------xxxx--xx-x-----------------xxXXXX----x--------xxQQ?-[]--x--------------------------------
QQQ?------xx---xxx---x---------------xxXXXXX-----x------xx-----[]---x------------------------------x
---------xx-----x-----xx------------xxXXXXXX------x----xx------[]----x----------------xxx---------xx
xxxxxxxxxxX-----X-----X-xxxxxxxxxxxxxXXXXXXX-------xxxxx--X----[]-----xxxxxxxxxxxxxxxxx--xxxxxxxxxx-
XXXXXXXXXXX-----X-----XXXXXXXXXXXXXXXXXXXXXXXXXXXXXXXXXXXXXXXXXXXXXXXXXXXXXXXXXXXXXXXXX--XXXXXXXXXXX