--------------------------------------------------
--------------------------------------------------
--------------------------------------------------
--------------------------------------------------
--------------------------------------------------
--------------------------xxxx--------------------
---E----------------------x?X-x-------------------
xxxxxxx--------------xxxxxx-X--x------------------
SSSSSSSx------------xx---xE-X---x-----------------
--------xx---------xx----<>-X----x----------------
-------<>-x------xxx-----[]-X-----x---------------
>------[]--x----xx<>-----[]-X------x-----xxxxx----
E--E---[]---xxxxx-[]--E--[]-X-------xxxxxx----xxxx
XXXXXXXXXXXXXXXXXXXXXXXXXXXXXXXXXXXXXXXXXX---XXXXX