----------------------------------------------------------------------------------------------------
----------------------------------------------------------------------------------------------------
----------------------------------------------------------------------------------------------------
--------------xxx--------------------------------------------------------------------------------xxx
----xxxx----xxx--x---------------------------------------------------------------------xxxx----xxx--
---xx---x--xxXS---x---------------------------------------------------E---------------xx---x--xxXS--
E-xx-----xxxEX-----x-------------------------------------------------<>--------------xx-----xxxEX---
-xx-------xXXX------x------------------------------------------------[]-------------xx-------xXXX---
xx--------XXXXS------x----------x-------B----------------------------[]-----------xxx--------XXXXS--
<>-------XXXXX--------x---------B-------b-------------------------XXXXSSS--------xx<>-------XXXXX---
[]------XXXXXX---------x--------b--?-B------?QQ--------------------------xxxx---xx-[]------XXXXXX---
[]-----XXXXXXX----------x-------B----b---------------------xxxx---xxx---xx<>-x-xx--[]-----XXXXXXX---
[]----XXXXXXXX---------X-xxxxxxxxxxxxxxxxxxxxxxxxxxxxxxxxxxx---xxxx--xxxx-[]--xx---[]----XXXXXXXX---
XX----XXXXXXXXXXXXXXXX-XXXXXXXXXXXXXXXXXXXXXXXXXXXXXXXXXXXXX---XXXX--XXXXXXXX-XXXXXXXXX-XXXXXXXXXXXX