--------------------------------------------------
--------------------------------------------------
--------------------------------------------------
XX------------------------------------------------
--------------------------------------------------
-------------------------xxxx-----xxx-------------
------------------------xx---x---xx--x------------
xxxE-------------------xx-----x-xx----x-----------
SS-x-----------------xxx-------xx------xxx--E-----
----x---------------xxXX------XXX-----XXS-x-----oo
o----x-------------xx-X--------------------x------
------x------xxxx-xx------------------------xxxxxx
o------xxxxxxx---xx-------------------------XXXXXX
XXX----XXXXXXX---XX-------------------------X-----