----------------------------------------------------------------------------------------------------
xxxxxxxxxxxxx---xxxxxxxxxxxxxxxxxxxxxxxxxxx--------------xxxxxxxxxxxxxxxxxxxxx----------------------
SSSSSSSSSSSSS---SSSSSSSSSS-SSSSSSSSSSSSSSS-x-----SSSS---xxSSSSSSSSSSSSSSSSSSSS-----------------SSSSS
--------------------------------------------x----------xx-------------------------------------------
---------------------------------------------x----?---xx--------------------------------------------
----------------------------------------------x--S??-xx---------------------------------------QQQ?QQ
-----------------------------------------------x----xxXXX-------------------------------------------
------------------------------------------------x--xx-----------------------------------------------
---E----------------------------------E----------xxx---------------------E--------------------------
E-<>-------S--------E----------------<>------XXX-SSSS----------------E--<>----------------------SSSS
>-[]-------SS------<>-------------XX-[]--XXX------------------E-----<>--[]--SS----------------------
]-[]-------SS------[]------------XXX-[]--XXX-----------------<>-----[]--[]--SS-----------------E---E
]-[]-------SSxxxxx-[]--------E-E-XXX-[]--XXX-----------------[]---E-[]--[]--SSxxxxxxxxxxxxxxxxxxxxxx
XXXX--XXXXXXXXXXXXXXXXXXXXXXXXXXXXX--XX--XX------XXXX------XXXXXXXXXXXXXXX--XXXXXXXXXXXXXXXXXXXXXXXX