----------------------------------------------------------------------------------------------------
----------------------------------------------------------------------------------------------------
SSSSSSSSSSSSS?SSSSSSSSSSSSSSSSSSSSSSSSSSSSSSSSSSSSSSSSSSSSSSSS--------------------------------------
SSS-------------------------------------------------------------------------------------------------
SSS-------------------------------------------------------------XXX-X----E--------------------------
--------oooooo--------------------------------------------------------------------------------------
-----------------------------xx---------------------------------------------------------------------
--------SSSSSS--------------xx-x-xxx---------------------------------------------------------------x
E-------SSSSSS-------------xx---xx--x---------------------xxxxxxxx--SSSSS??-----------------------xx
SSS----------------------xxx----<>---x------xxxx---------xxXXXX-x-x------------------------------xx-
------------------------xx<>----[]----xxx--xxSS-x-------xxEXXXX-X--x---------------------------xxx--
x-xxxxxx---------------xx-[]----[]----<>-xxx-SS--x-----xxXXXXXX-----x------xxx------xxxx------xx<>--
-xx-----xxxxxxxxxxxxxxxx--[]----[]--E-[]--x--SS---xxxxxxXXXXXXX------xxxxxxx--xxxxxxx---xxxxxxx-[]--
XXX----XXXXXXXXXXXXXXXXXXXXXXXXXXXXXXXXXXXX--XX--XXXXXXXXXXXXX------XXXXXXXX--XXXXXXX--XXXXXXXXXXXXX