----------------------------------------------------------------------------------------------------
-----------------------------------------------------------------------------------------------xx---
----------------------------------------------------------------------------------------------xx-x--
-----------------------------------------------------------------xxx-------------------------xx---x-
-----xxx----xxxx---------------------------------------xxxx----xxx--x-------------------xxxxxx-----x
----xx--x--xxXX-x-------------------------------------xx---x--xxXS---x-----------------xx--XXX------
---xx----xxxEXX--x-----------------------------------xx-----xxxEX-----x---------------xx---XXX------
--xx------xXXXX---x------------------------xxxxx----xx-------xXXX------x-------------xx----XXX------
xxx-------XXXXX----x---------------------xxx----x-xxx--------XXXXS------x----------xxx----XXXX------
x<>------XXXXXX-----x------------------xxx<>-----xx<>-------XXXXX--------x--------xx<>----XXXX------
-[]-----XXXXXXX------x----------------xx<>[]-----<>[]------XXXXXX---------x------xx-[]----XXXX------
-[]----XXXXXXXX-------xx-------------xx-[][]-----[][]-----XXXXXXX----------x----xx--[]----XXXX------
o[]--X-XXXXXXXX-------X-xxxxxxxxxxxxxx--[][]-----[][]----XXXXXXXX-----------xxxxx---[]----XXXX------
XXXXXXXXXXXXXXXXXXXXXXXXXXXXXXXXXXXXXXXXXXXXXXXXXXXXXXXXXXXXXXXXXXXXXXXXX---XXXXXXXXXXXXXXXXXXXXXXXX