----------------------------------------------------------------------------------------------------
----------------------------------------------------------------------------------------------------
SSSSSSSSSSSSSSSSSSSSSSSSSSSSSSSSSSSSSSSSSSSSSSSSSSSSSSSSSSS?SSSSSSSSSSSSSSSSSSSSSSSSSSSSSSSSS-------
----------------[----------------SSSSSSSSSSSSSSSSSSSSS------SSSSSSSSSSSSSSSS-------[]---------------
----------------[----------------SSSSSSSSSSSSSSSSSSSSS------SSSSSSSSSSSSSSSS-------[]---------------
----------------[----------------SSSSSSSSSSSSSSSSSSSSS------SSSSSSSSSSSSSSSS-------[]----------xx--x
----------------[----------------------------------------xxxxx---------------------[]---------xx-xxx
----------------[------------------------xxxxx------xxxxxx-S--x--------------------[]-----E--xx--XXX
xxxxxxxxxxxxxxxx]xxxxxxxxxxxxxxxxxxxxxxxxx----xxxxxxxE--<>-----x------xxxxxxx------[]----xx-xx------
Q????S?????SSSSSxSS??S??S????????SSSSSSSS?----SSSSSSSS--[]------x--xxxx-<><>-x-----[]-xxxx-xx-------
SSSSSSSSSSSSSSSSSSSSSSSSSSSSSSSSS-----------------------[]-------xxxXXX-[][]--x----<>xxXXX-XX-------
SSSSSSSSSSSSSSSSSSSSSSSSSSSSSSSSS----------<>-----------[]-------EEXXXX-[][]---x----xx--------------
SSSSSSSSSSSSSSSSSSSSSSSSSSSSSSSSS----------[]-----------[]------E-XXXXX-[][]----xxxxx---------------
XXXXXXXXXXXXXXXXXXXXXXXXXXXXXXXXXXXXXXXXXXXXXXXXXXXXXXXXXXXX-XXXEXXXXXX-XXXXXXEXXXXXXE-----------XXX