----------------------------------------------------------------------------------------------------
-------------------------------------------------------------------------xxx------------------------
SSSSSSSSSSSSSSSSSSSSSSSSSSSSSSSSSSSS------------------------------------xx--x--------------------E--
SSSSSSSSSSSSSS-------------------[]------------------------------------xx----xx---------------------
SSSSSSSSSSSSSS---<---------------[]-----------------------------------xx-----E-xxxxxx------------?--
SSSSSSSSSSSSSS-----------S-------[]-----------xxxxx-----------------xxx---------x----x-------SSSS?SS
------S----S-------------S-------[]----------xx-<>-x---------------xx-S--------<>-----x-------------
------S----S-----------S-S-------[]---------xx--[]--x-------------xx-----------[]------xxxx---------
------So??-Soo---------SoS-------[]-------xxx---[]---x-----------xx------------[]-------xB-xxxxxxx--
------SSS--SSS------E--SSS-------[]------xx<>--QQQ?---x---------xx-------X-----XX-------XXXXESSSSS?S
xx------------------>------------<>-----xx-[]----------x-------xxE---------------------XXXXXX-------
E-xxx----------------------------------xx--[]-----------x-----xx<>--------------------XXXXXXX-------
--XX-xxxxxxxxxxxxxxxxxxxxxxxxxxxxxxxxxxx---[]------E-----xxxxxx-[]-----X-------------XXXXXXXX-------
XXXXXXXXXXXXXXXXXXXXXXXXXXXXEEXXXXXXXXXXXXXXXX-----X---XXXXXXXXXXXXXXXXX-------------XXXXXXXXXXXXXXX