--------------------------------------------------
--------------------------------------------------
--------------------------------------------------
--------------------------------------------------
--------------------------------------------------
xxxx----------------------------------------------
x---x---------------------------------------------
X----x--------------------------------------------
X-----x---------E---------------------------------
X------x----------xxxx-----------------------xxx--
XS------x--------xx<>-x---------------------xxX-x-
XS-------x------xx-[]--x-----------------B-xx-X--x
XSx------Xxxxxxxx--[]---xxxxxxxxxxxxxxxxxxxx--X---
XSXXXXXXXXXXXXXXXXXXXXXXXXXXXXXXXXXXXXXXXXXX--XXXX