----------------------------------------------------------------------------------------------------
----------------------------------------------------------------------------------------------------
------------------------------------------?---------------------------------------------------------
----------------------------------------------------------------------------------------------------
---------------------------------------------E------------------------------------------------------
-----------------------------------------S-------------------SSSSSS---------------------------------
----------------------------------------------------------------------------------------------------
----------------------------------------------------------------------------------------------------
S-------------------xxx-----------xxxxxxxxxxx------xx----------xxxxx----------E--S-----------------x
------------xxxxxxxxx--x-xxxxx---xx-XXXXXXXX-x----xx-x-------xxxSSS-x--------<>---------xxx-------xx
-----------xxXXXXXXXX---xx----x-xx------------x--xx---x-----xx<>-----x----------xxx----xx--x-----xxX
--xxxx----xx-XX---------<>-----xx--------------xxx-----xxx-xx-[]------x--------xxS-x--xx--X-x---xxXX
xxx---xxxxx--XX---------[]-----<>---------------x------XX-xx--[]-------xxxxxxxxx-S--xxxX--X--xxxxXXX
XXX---XXXXXXXX----------[]-----[]-------------XXX------XXXXXXXXXXXXX---XXXXXXXXXXXXXXXXXXXXXXXXXXXXX