--------------------------------------------------
--------------------------------------------------
--------------------------------------------------
---------------------------xx---------------------
-----------------------------x--------------------
-------------XX---------------x-------------------
-------------[]----------------x------------------
-------------[]-----------------x-----------------
--xxxx-------[]------------------x----------------
-xx---xx-----<>SSSS---------------x---------------
xx----X-x--------------------------x--------------
x-----XX-xx---Exxxxxx---------------x-------------
B-----XXXX-xxxxxE----xxxxxxx-------XExxxxxxxxxxxxx
X-----XXXXXXXXX<>----XXXXXXXXXXXXXXXXXXXXXXXXXXXXX