---------------------------------------------------------------------------xxxxxx-------------------
xxxxxxxxxxxxxxxxxxxxxxxxxxxxxxxxxx--------------xxxxxxxxxxxxxxxxxxxxxxxxxxxx-XXX-xxxxxxxxxxxxxxxxxxx
>SSSSSSSSSSSSSSSSSSSSSSSSSSSSSSSS-x-----SSSS---xxSSSSSSSSSSSSSSSSSSSSSSSSSSS-----SSSSSSSSSSSSSSSSSSS
]----------------------------------x----------xx---------------------------------SSSSSSSSSSSSSSSS---
]-----------------------------------x----?---xx----------------------------------SSSSSSSSSSSSSSSS---
]------------------------------------x--S??-xx-----------------------------------SSSSSSSSSSSSSSSS---
]-------------------------------------x----xxXXX---------------------------------S------------------
]--------------------------------------x--xx-------------------------------------S------------------
]--------S------------------XE----------xxx---------------------E-----------------?oooooooooo-------
]So----E----E---------------<>------XXX-SSSS----------------E--<>-----------------??SSSSSSSSS----XX-
S-----<>---<>------------XX-[]--XXX------------------E-----<>--[]----------XX-------------------XXX-
X-----[]---[]-----------XXX-[]--XXX-----------------<>-----[]--[]---------XXXXXX---------------XXXX-
X-----[]---[]-------E-E-XXX-[]--XXX-----------------[]---E-[]--[]--------XXXX------------EE---XXXXX-
XXXXXXXXXXXXXXXXXXXXXXXXXX--XX--XX------XXXX------XXXXXXXXXXXXXXX--XXXXXXXXX-----XXXXXXXXXXXXXXXXXXX