----------------------------------------------------------------------------------------------------
----------------------------------------------------------------------------------------------------
SSSSSSSSSSSSSSSS-------------SSS--[]SSSSSSSSSSSSSSSSS-----------------------------------------------
[---------------------------------[]SSSSSSSSSSSSSSSSS-----------------------------------------------
[---------------------------------[]SSSSSSSSSSSSSSSSS-----------------------------------------------
[---[------------xx--xxxxx--------[]SSSSSSSSSSSSSSSSS-----------------------------------------------
[---------------xx-xxx----x-------[]SSSSSSSSSSSSSSSSS-----------------------------------------------
[--------------xx--XXX-----x------[]SSSSSSSSSSSSSSSSS-----------------------------------------------
-xxxx------xxxxx------------x------]SSSSSSSSSSSSSSSSS-----------------------------------------------
xx---x----xx-XXX-------------xxxxx-]SSSSSSSSSSSSSSSSS---E--EE-----------------E--EE-----------------
->----x--xx-----------SSS-S--SSSSSSSSSSSSSSSSSSSSSSSS--<>--<>--------E-------<>--<>-----------------
<]-----xxx------------SSS-S--SSSSSSSSSSSSSSSSSSSSSSSS--[]--[]-----------------]--[]-----------------
b]-E-E--xX------------SSS-S--SSSSSSSSSSSSSSSSSSSSSSSS--[]--[]-----------------]--[]-----------------
XXXXXXXXXX---------XXXSSS-S--XXXXXXXXXXXXXXXXXXXXXXXX--[]--[]-----------------]--[]---------o----E--