----------------------------------------------------------------------------------------------------
----------------------------------------------------------------------------------------------------
SSSSSSSSS-------------------------------------------------------------------[]SSSSSSSSSSSSSSSS------
[]---SSSS--------------------------------------------xxx--------------------[]SSSSSSSSSSSSSSSS------
[]---SSSS--------xxxxxx-----------------------------xxX-x-------------------[]SSSSSSSSSSSSSSSS------
[]---SSSS-------xx--QQ-x---------------------------xxXX--x------------------[]SSSSSSSSSSSSSSSS------
[]---SSSS------xx-------x-------------------------xxXXX---x-----------------[]SSSSSSSSSSSSSSSS------
[]---SSSS-----xx---------x-----------------------xxXXXXXX--x----------------[]SSSSSSSSSSSSSSSS------
<>---SSSS---xxx-----SS----x---------------------xxXXXXX-----x----xx---xx-----]SSSSSSSSSSSSSSSS------
-----XSSS--xx<>--------XX--x----SSQS-------xxxxxxXXXXXX------x--xx-x-xx-xxxx-]SSSSSSSSSSSSSSSS------
-------SS-xx-[]-------XXX---x-------------xxE--xXXXXXXX-------xxx---xx--SSSSSSSSSSSSSSSSSSSSSS---E--
-------SSxx--[]-------XXXX---x-----------xx<>-XXXXXXXXX-E------x----<>--SSSSSSSSSSSSSSSSSSSSSS--<>--
xxxxxxxxxx---[]----E--XXXX---Exxxxxxxxxxxx-[]-XXXXXXXXX<>-----<>----[]--SSSSSSSSSSSSSSSSSSSSSS--[]--
XXXXXXXXXXXXXXXXXXXXXXXXXXXXXXXXXXXXXXXXXXXXXXXXXXXXXXX[]-----[]----[]--SXXXXXXXXXXXXXXXXXXXXX--XX--