----------------------------------------------------------------------------------------------------
----------------------------------------------------------------------------------------------------
----------------------------------------------------------------------------------------------------
----------------------------------------------------------------------------------------------------
------------------------------------------xxxx-------------------------------------------xxx--------
-----------------------------------------xx---xSSS--------------------------------------xx--x-------
----------------------------------------xx-----x--xxxxxxxxxx---------------------------xx----x------
---------------------------------------xx-------xxxXXXXXXXX-x-------------------------xx------xxx---
xxxx---xxx--------------xxx-----xxxxxxxx---------xXXXXXXXX---x----xx-----------xxxxxxxx--------x-x--
xSS-x-xx--xxxxxxxxxxxxxxx--x---xx-XXXXXX---------XXXX---------x--xx-x-xxxxx---xx-XXXXXX--------S--xS
X----xxX--XXXXXXXXXXXXX<>---x-xx----------------XXXXX----------xxx---xx----x-xx--------------------x
S--SSxXX--XX-----------[]----xx----------------XXXXXX-----------x----<>-----xx----------------------
S--SSXXX--X------------[]----<>---------------XXXXXX----<>-----<>----[]-----<>----------------------
XXXX-XXXX-X------------[]----[]---------------XXXXXX----[]-----[]----[]-----[]----------------------