------xxx-----------------------------------------
xxxxxxx--x----------------------------------------
XXXXXXX---x------------SSSSSSSSSSSSSSSSSSSSSSSSSSS
XXXXXXX----x-------------[]----[]-----------------
XXXXXXX-----x------------[]----[]-------E---------
XXXXXXX------x-----------[]----[]---QQQQQQ--------
XXXXXXX-------x----------<>----[]----------------x
XXXXXXX--------x---------------[]---------------xx
XXXXXXX---------x--------------[]--xxxxxxxxxxxxxx-
XXXXXXX----------x-------------[]-xxSSSSSSSSSSSSS-
XXXXXXX-----------x------------<>xx-SSSSSSSSSSSSS-
XXXXXXX------------x----xxx-----xx--SSSSSSSSSSSSS-
XXXXXXX-----------X-xxxxx--xxxxxx---SSSSSSSSSSSSS-
XXXXXXX--XXXXXXXXXXXXXXXX--XXXXXXE--XXXXXXXXXXXXXX