----------------------------------------------------------------------------------------------------
x---------------------------------------------------------------------------------------------------
----------------------------------------------------------------------------------------------------
----------------------------------------------------------------------------------------------------
----------------------------------------------------------------------------------------------------
--E-------------------------E-------------------------------E----SSS--------------------------------
---------------------------->-----------------------------------------------------------------------
xx------------------E-------]------------------B----------------------------------------------------
<-x-------xxx---------------]------------------b----------------------------E----xxxx----S----------
[--xxxxxxxx--x--------------]----------------SSXSS-------xxxxx---SSS------------xx<>-x--------------
SSSXXXXXXXX---x--------------------E---B----------------xx-<>-x----------o-----xx-[]--x-------------
XSS------------x------xxx--------------b-----------B---xx--[]--x---------o----xx--[]---x-----xxx----
XS--------------xxxxxxxX-xxxxxxxxxxxxxxxxxxxxxxxxxxxxxxx---[]---xxxxxxxxxxxxxxx---[]----xxxxxx--xxxx
XS-X-----------XXXXXXXXXXXXXXXXXXXXXXXXXXXXXXXXXXXXXXXXX--XXXXXXXXXXXXXXXXXXXXXXXXXXXXXXXXXXXX--XXXX