----------------------------------------------------------------------------------------------------
----------------------------------------------------------------------------------------------------
----------------------------------------------------------------------------------------------------
--------------------------------------------------------------------------------------------------xx
-------------xxxxxxxxxxxxx--------------------E----------------------E--------------S------------xx-
------------xx--QQQ?QQSQQ-x---------------E-SSQS--SQS--------QQQQQQQQQQQQ----------SSSSSSSS------xX-
-----------xx--------------x--------------------------------------------------------------------xx--
----------xx------E----E----x-------------------------------------------------------------------x---
--------xxx-----SSSSSSSSS----x----------------------------------------E-----------------------xxx---
-------xx<>-------------------x---------Q----SQS--S?S-------QQQQQQQQQQQQQQ-------------SSS---xx<>---
E-----xx-[]-------X----X-------x-------------------------E-----------------------xxxx-------xx-[]---
>----xx--[]-------X----X--------x-------xxx--------------------xxxx-------------xx<>-x-----xx--[]---
]xxxxx---[]----E--X----X-------X-xxxxxxxx--xxxxxxxxxxxxxxxxxxxxxE--xxxxxxxxxxxxxx-[]--xxxxxx---[]---
XXXXXXXXXXXXXXXXXXXXXXXXXXXXXXXXXXXXXXXXX--XXXXXXXXXXXXXXXXXXXX<>-XXXXXXXXXXXXXXXXXXXXXXXXXXEXXXX---