----------------------------------------------------------------------------------------------------
--------------------------------xx------------------------------------------------------------------
-------------------------------xx-x-----------------------------------------------------------------
xxx--------------------xx-----xx---xx---------------------------------------------------------------
---x------------xxx---xx-xxxxxx------x-----------------------xxxxxx---------------------------------
----x---------xxx--x-xx--SSSSSSS------x---------------------xx?SSS-x--------------------------------
-----x---------<>---xx--------------E--x-----xxxx-----------x-------x--------------------------XX---
x----Ex--------[]---<>-------------<>---x---xx---x------xxxxx-------Ex------------------------XXX---
----<>-xx------[]---[]-------------[]----x-xx-----xxx--xx--xE------<>-x----------------------XXXX---
----[]---xx---SXX---XXX--------ES--[]-----xx------<>-xxx---<>---E--[]--x---------------E----XXXXX---
----[]--<>-x------------------<>---[]-----<>------[]--x----[]--<>--[]---x-------------<>---XXXXXX---
----[]--[]--x------------<>---[]---[]-----[]------[]-<>----[]--[]--[]----x-xxxxx------[]--XXXXXXX---
----[]--[]---xxxx--------[]---[]-E-[]-----[]-E----[]-[]----[]--[]--[]-----xx----xxxxxx[]-XXXXXXXX---
XXXXXXXXXXXXXXXXXXXXXXXXXXXXXXXXXXXXXXXXXXXXXXXXXXXXXXXXXXXXXXXXXXXXXXXXXXXX---XXXXXXXXXXXXXXXXXX---