----------------------------------------------------------------------------------------------------
----------------------------------------------------------------------------------------------------
----------------------------------------------------------------------------------------------------
----------------------------------------------------------------------------------------------------
-------------------------------------------------------------------xxxxx-------------------------xxx
-----xx-------------------------------E-E-E------------SS-------xxxx--X-x-----------------------xx--
S---xx-x-----------------------------<><><>--------------------xx--E--X--x---------------------xx-E-
---xx---xxx--------------------------[][][]-------------------xx---XX-X---x-------------------xx----
--xx----<>-x---------------------Q?--QQQQQQ--------------xxxxxx----XX-X----x------------xxxxxxx-----
xxx?----[]--xx--------------------------------------Q--xxx---<>----XX-X-----x----------xx-XXXXX-----
x<>-----[]----x--------------------------------xxxx---xx<>---[]----XX-X------x--------xx------------
-[]-----[]-----x------------------xxx---------xx<>-x-xx-[]---[]----XX-X-------S------xx-------------
-[]-----[]------xxxxxxxxxxxxxxxxxxx--xxxxxxxxxx-[]--xx--[]---[]----XX-X-------xxxxxxxx--------------
XXXXX---XXXXXXXXXXXXXXXXXXXXXXXXXXX--XXXXXXXXXXXXXX-XXX-XX--XXX-X-XXX-XXXXXXXXXXXXXXXX--------------