----------------------------------------------------------------------------------------------------
-----------------------------------------------------xxxxxxxxxxxxxxxxxxxxxxxxxxxxxxxxxxxxxxxxxxxxxxx
SSSSSSSSSSSSSSSSSSSSSSSSSSSSSSSSSSSSSSSSSSSSS------xxxSSSSSSSSSSSSSSSSSSSSSSSSSSSSSSSSSSSSSSSSSSSSSS
--[------------------------------------------------xx-----------------------------------------------
--[-E-------------X----------------------------XXX-xx-----------------------------------------------
-QQQQQ------------xxxxxxx------------E--------xxxx-xSSS-----------E---------------------------------
-----------------xxSSSSSS--------------------xx---xx-------------<>---------------------------------
------------E---xx-SSSSSS------------xxxx---xx-----xS------------[]---------------------------------
xxxxxxxxxxxxxxxxx--SSSSSS----------xxx---xxxx------S-S-----------[]-------S-------------------------
>SSSSSSSSSSSSSSSS--SSSSSS---------xx<>---QQQQ---------S-----E--SS[]SS---E----E---------------<>-----
SSSSSSSSSSSSSSSSS--------x--X----xx-[]---------------------<>----[]----<>---<>---------------[]----S
SSSSSSSSSSSSSSSSS---------x-X---xx--[]---------------------[]----[]----[]---[]---------------[]----S
SSSSSSSSSSSSSSSSS----------xxxxxx---[]---------------------[]-E--[]----[]---[]-------ooooo---[]----S
XXXXXXXXXXXXXXXXXXXXXXXXXXXXXXXXXXXXXXXXXXXXX------XXXXXXXXXXXXXXXXXXXXXXXXXXXXXXXXXXXXXXX---[]----S