----------------------------------------------------------------------------------------------------
----------------------------------------------------------------------------------------------------
-<E-------------------------------------------------------------------------------------------------
-[]-------------------------------------------------------------------------------------------------
-[]------------------------------------------------------------------------xxxx---------------------
-[]----------------------------------------------SSSSSSSS---------------xxxx---x--------------------
S[]--------------------------------------------------------------------xx-<>----x-------------------
----------------------------------------------------------------------xx--[]-----x------------------
------------------------S----------------xxxx---------xxxx----------xxx---[]------x-----------------
-xxxx--------xxx---------------xxx------xx<>-x-------xxXXXx--------xx<>--QQQ?------x----------------
xx---xx-----xx--xx-----xxx----xxX-x----xx-[]--x-----xx-----x------xx-[]------<>-----x--------------x
x---<>-x---xx--<>-x---xxS-x--xx-X--x--xx--[]---x----x-------x----xx--[]------[]------x------------xx
X---[]--x-xx---[]--xxxx-S--xxx--X---xxx---[]----xxxxx--------xxxxx---[]------[]------Xxxxxxxxxxxxxx-
X---[]---xx----XXXXX<>XXXXXXXXXXXXXXXXXXXXXXXXXXXXXXX------XXXXXXXXXXXXX-----XX----XXXXXXXXXXXXXXXXX