----------------------------------------------------------------------------------------------------
----------------------------------------------------------------------------------------------------
-----------------------------------------------------------------------------------------SSSSSSSSSSS
----------------------------------------------------------------------------------------------------
------oo--------------------------------------------------------------------xxxx--------------------
------XX-------------------------------------------------------------------xxXX-x-------------------
--------------------------------------------------------------------------xxXXX--x------------------
x------------------------------------------------------------------------xxXXXX---x-----------------
-x----------xxx---------xxxx--------------------------xx----------------xxXXXXX----x----------------
--x--------xx--x-------xx<>-x------------------xxxx--xx-x--------------xxXXXXXX-----x---------x----x
Q----?----xx----x-----xx-[]--x----QQQQQQ?-----xx---xxx---x------------xxXXXXXXX------x-----------Exx
---------xx----------xx--[]---x--------------xx-----x-----xx---------xxXXXXXXXX-------x----------xx-
----xxxxxx------Xxxxxx---[]----xxxxxxxxxxxxxxxX-----X-----X-xxxxxxxxxxXXXXXXXXX--------xxxxxxxxxxxX-
XXXxxXXXXX------XXXXXXXXXXXXXXXXXXXXXXXXXXXXXXX-----X-----XXXXXXXXXXXXXXXXXXXXXXXXXXXXXXXXXXXXXXXXX-