-----------xxx--------------------------------------------------------------------------------------
----------xx--x-------------------------------------------------------------------------------------
---------xx----x------------------------------------------------------------------------------------
---xxxxxxx------x-------------xxx-------------------------------------------------------------------
--xx----x--------x---------xxxx--x------------------------------------------------------------------
--xX----E---------x-------xx--X---x-----S---------XQQ?QQX------------E------------------------------
-xx----<>----------x-----xx--------x----S---------X-----X-----------<>------------------------------
-x-----[]-----------xxxxxxE---------x-------------X-----X-----------[]--------xxxxx-----------------
xx-----[]------------x---<>----------x--SSS-------XE-E--X-----------[]------xxx----x----------------
<>-----[]------------?---[]-----------x-SSS-------XQQ-QQX-----------XXX----xx<>-----x---------------
[]-----[]----------------[]------------xSSS-------------------------------xx-[]------x--------xxxx--
[]-----[]----------------[]--------------SSx------------E-------xxx------xx--[]-------x------xx<>-x-
X]-----[]------E---------[]------------X-SS-xxxxxxxxxxxxxxxxxxxxx--xxxxxxx---[]---E----xxxxxxx-[]--x
XX-----XXXXXXX<>XXXXXX---XXXXXXX-------XXXXXXXXXXXXXXXXXXXXXXXXXX--XXXXXXXXXXXXXXXXXXXXXXXXXXXXXXXXX