----------------------------------------------------------------------------------------x-----------
----------------------------------------------------------------------------------------------------
SSSSSSSSSSSSSSSSSSSSSSSSSSSSSSSSSSSSSSSSSSS?SSSSSSSSSSSSSSSSSSSSSSSSS?SSSSSSSSSSSSSSSSSSSSSSSSSSSSSS
-------SS--SSSSSS--SSSS------SSSS-------------------------------------------------------------------
-------SS--SSSSSS--SSSS--E---SSSS-------------------------------------------------------------------
-----SS--------SS---S----SS----------ooooooo---------------------ooooo------------------------------
-----SS--------SS---S----SS------------------------------------------------------------xx-----------
-----SS--------SS---S----SS----------SSSSSSS--------------------SSSSSS----------------xx-x-------xxx
-----SS----ooooSS---So??-SS---E------SSSSSSS--------------------SSSSSS---------------xx---x-----xxXX
-----SSSS--SSSSSS---SSS--SS--SSSS-----------------------xxxx-----------------------xxx-----x---xxXXX
QQ-----SS-------------------EE-------------------------xxSS-x---------------------xx<>------x-xxXXXX
-------SS-----------------------xxxxx----------------Exx-SS--x-------------------xx-[]-------xxXXXXX
xxxxxxxxxxxxxxxxxxxxxxxxxxxxxxxxx----xxxxxxxxxxxxxxxxxx--SS---xxxxxxxxxxxxxxxxxxxx--[]-------XXXXXXX
XXXXXXXXXXXXXXXXXXXXXXXXXXXXXXXXX---XXXXXXXXXXXXXXXXXXX--XX--XXXXXXXXXXXXXXXXXXXXXXXXXXXX----XXXXXXX