----------------------------------------------------------------------------------------------------
-------xxx---------------------------------------xxxxxxxxxxxxxxxxxxxxxxxxxxxxxxxxxxxxxxxxxxxxxxxxxxx
------xx--x--------x---------------------------xxxSS????SSSSSSSSSSSSSSSSSSSSSSSSSSSSSSSSSSSSSSSSSSSS
-----xx----xx-------------------------------xxxxSS--------------------------------------------------
xx--xx-----E-xxxxxx-------------------------xSSS----------------------------------------------------
--x-x---------x----x---------SSS------------x-------------------------------------------------------
---xx--------<>-----x----------------------xx-------------------------------------------------------
----x--------[]------xxxx-----------------xxS-------------------------------------------------------
-E--S--------[]-------xB-xxx------------xxx-------XXXXX---------------------------E-----------------
<>-----------XX-------XXXXE-xSSS-------xx<>------XXXXXX-------------------E------<>-----------------
[]-------------------XXXXXX--x--------xx-[]-----XXXXXXX------<-----XXX-------XXX-[]--XXX-----XXX----
[]------------------XXXXXXX---x------xx--[]----XXXXXXXX---XXX[---------------XXX-[]--XX-------------
b]-E---------------XXXXXXXX----xxxxxxx---[]---XXXXXXXXX----------------------XXX-[]-----------------
XXXXXXX-X----------XXXXXXXXXXXXXXXXXXXXXXXXXXXXXXXXXXXXX---------------------XX--XX-----------------