----------------------------------------------------------------------------------------------------
----------------------------------------------------------------------------------------------------
----------------------------------------------------------------------------------------------------
----------------------------------------------------------------------------------------------------
---------------------------------------------------------------------------------------------------x
--------------------------------------------------------------------------------------------------xx
-------------------------------------------------------------E-----------------------------------xx-
-------xxxxxxx----------------------------------------------------------------------------------xx--
-----xxx---<>-x----------------x-----------------------------------E--------oo--------------xxxxx---
----xx<>---[]--x------------------------------E--EE---------------<>-------xxxx-----------xxx--<>---
---xx-[]---[]---x----------------------------<>--<>---------------[]------xx---x---------xx<>--[]---
--xx--[]---[]----x--------------------xxx<>--[]--[]---------------[]-----xx-----x-------xx-[]--[]---
xxx---[]---[]-----xxxxxxxxxxxxxxxxxxxxx--[]--[]--[]---------------[]----xx-------xxxxxxxx-?[]--[]---
XXX--XXX---XXXXXXXXXXXXXXXXXXXXXXXXXXXX--[]--[]--[]---------------XXXXXXXX------XXXXXXXXXX-XX--XX-XX