----------------------------------------------------------------------------------------------------
----------------------------------------------------------------------------------------x-----------
SSSSSSSSSSSSSSS-----SSSSSSSSS----------------SS-------------?----------------------------xx---------
SSSSSS-------[]----------------------------------------------------------------------------xx-------
SSSSSS-------[]-------------xxxxx------------------------------------------------------------x------
SSSSSS-------[]------xxxxxxxx----x----------SSSS-------------------xxxxx----------------------x---xx
-------------[]------xSSSSSSS-----x---------------------------SS--xx----x----------------------x--x-
-------------[]------xSSSSSSS------x-----------------------------xxX-----x----------------------xxx-
x-xxxxx------[]---xxxxSSSSSSS-------x--------E------------SS----xxXX------x----------------E-----x--
-x<><>-x-----[]--xx--?SSSSSS---------x------SSSS-xxx-----------xxXXX-------x------------x-<>-----?S-
--[][]--x----<>-xx-------------S------xxx-------xxX-x--B------xxXXXX--------x----------xx-[]--------
>-[][]---x-----xx---------------------<>-x-----xx-X--x-b----xxxXXXXX---------x--------xx--[]--------
]-[][]----xxxxxx----------------------[]--xxxxxx--X---xxxxxxx-XXXXXX--------X-xxxxxxxxx---[]--------
XXXXXXXXEXXXXXXX----XXXXXXXXX-------XXXXXXXXXXXXXXXXXXXXXXXXX-XXXXXXXSS----XXXXXXXXXXXXXXXXXXXXXXX--