----------------------------------------------------------------------------------------------------
-------------------------------------x--------------------------------------------------------------
SSSSSSSSSSSSS-----------------------Sx--------------------------------------------------------------
----------------------------------------------------------------------------------------------------
---------------------------xxxxxxxx-----------------------------------------------------------------
?-------------------------xx-SSSSS-x-----------------------SSSS--------SSSSS------SSSS--------------
-------------------------xx---------x-xx------------------------------------------------------------
------------------------xx-----------x--x-----------------------------------------------------------
xxx--------------------xxX---------------x---------------------xxxx-------------------------xxxx----
x--xx----xxxx--------xxxEX---S------X-----x-------------------xx<>-x-QQQQ--QQQ-------------xx<>-x---
-----x--xxSS-x------xxXXXX----------X------x--E--------------xx-[]--x---------------------xx-[]--x--
------xxx-SS--x----xxXXXXX----------XX------xxxxxxxxx-------xx--[]---x-----------xxxxx---xx--[]---x-
----E--x--SS---xxxxxXXXXXX-----EE---XX-------x----x--xxxxxxxx---[]----xxxxxxxxxxxx----xxxxE--[]----x
XXXXEXXX--XX---XXXXXXXXXXXXXXXXXXXXXXXXXXXXX-X-XX-X-XXXXXXXXXXXXXXXXXXXXXXXXXXXXXX----XXXXXXXXXX---X