------------------------------------------------------------xxxxxxx---------------------------------
--------------------------------xxxxxxxxxxxxxxxxxxxxxxxxxxxxx------xxxxxxxxxxxxxxxxxxxxxxxxxxxxxxxxx
------------------------------xxxSS????SSSSSSSSSSSSSSSSSSSSSS------SSSSSSSSSSSSSSSSSSSSSSSSSSSSSSSS-
---------------------------xxxxSS----------------------------------SSSS-----------------------------
---------------------------xSSS------------------------------------SSSS-----------------------------
--------SSSS-----SS--------x---------------------------------------SSSS----E------------------------
---------[]---------------xx----------------------------------------------<>------------------------
---------[]--------------xxS----------------------------------------------[]------------E-----------
---------[]------------xxx-------XXXXX-------------------------------E----[]-----------<>-----------
xx-------[]-----------xx<>------XXXXXX------------------------------<>---?SSS--E-------[]-----------
B-x------<>----------xx-[]-----XXXXXXX-----------E----XXX-----------[]--------<>-------[]--<>-----E-
b--x-----xxx-----SSSxx--[]----XXXXXXXX---XXX------------------------[]--------[]---<>--[]--[]----<>-
B---xxxxxxE-xxxxxxxxx---[]---XXXXXXXXX--------------------------E---[]--------[]---[]--[]--[]----[]-
XXXXXXXXXXXXXXXEXXXXXXXXXXXXXXXXXXXXXXX----------------------XXXXXXXXXXXX----XXX---XX--XX--XX--XXXXX