----------------------------------------------------------------------------------------------------
----------------------------------------------------------------------------------------------------
----------------------------------------------------------------------------------------------------
----------------------------------------------------------------------------------------------------
----------------------------------------------------xxxx-----------------xxx------------------------
SSS---------------------------------S----S---------xx---xSSSSSSSSSSSSSS-xx--x-----------------------
--------------------------------------------------xx-S---x-------------xx----x----------------------
-------------------------------------------------xx-------x-----------xx------x---------------------
E------X---------------------------xxxx---------xx---------x-----xxxxxx--------x--------------------
Q?QQQQQX--------------------------xx<>-x-------xx-----------x---xxSSSSS---------x-----------------xx
---------------------------------xx-[]--x-----xxE------------x-xx--------S---E-------------------xx-
-------------xxx----------------xx--[]---x---xx<>-------------xx----------------X-------xxx-----xx--
xxxxxxxxxxxxxx-Exxxxxxxxxxxxxxxxx---[]----xxxx-[]-----X-------<>----------------XxxxxxxxxE-xxxxxx---
XXXXXXXXXXXXXX--XXXXXXXXXXXXXXXXXXXXXXXXXXXXXXXXXX-XXXX-------XXXXXXXXXX--------XXXXXXXX<>XXXXXXX---