----------------------------------------------------------------------------------------------------
----------------------------------------------------------------------------------------------------
----------------------------------------------------------------------------------------------------
----------------------------------------------------------------------------------------------------
----------------xxxxxxxxxxx----------E-E------------------xxxxx--------------------xxxxxxxxxxx------
---------------xx--QQQ?QQQ-x-------SSSSSSS-SS-xxxx-----xxxx--X-x------------------xx--QQQ?QQQ-x-----
--------------xx------------x-------------E--xx---x---xx--E--X--x----------------xx------------x----
-------------xx------E-------x--------------xx-----x-xx---XX-X---x--------------xx------E-------x---
x----------xxx-----SSSSSSS----x-----------xxx-------xx----XX-X----x-----------xxx-----SSSSSSS----x--
-x--------xx<>--------------E--x---------xx<>-------<>----XX-X-----x---------xx<>--------------E--x-
--x------xx-[]-------X------X---x---E---xx-[]-------[]----XX-X------x-------xx-[]-------X------X---x
---x----xx--[]-------X------X----x-----xx--[]-------[]----XX-X-------x-----xx--[]-------X------X----
----xxxxx---[]----E--X------X-----xxxxxx---[]-------[]----XX-X--------xxxxxx---[]----E--X------X----
XXXXXXXXXXXXXXXXXXXXXXXXXXXXXXXXXXXXXXXXXXXXX-------XX-XXXXX-XXXXXXXXXXXXXXXXXXXXXXXXXXXXXXXXXXXXXXX