----------------------------------------------------------------------------------------------------
----------------------------------------------------------------------------------------------------
----------------------------------------------------------------------------------------------------
----------------------------------------------------------------------------------------------------
-------------------------------------------------------------------------------------------xxx------
---------------------------SSS------------------------E------E----------------------------xx--x-----
---------------------------------------------------E-------------------------------------xx----x----
------------------------------xxx--------------xxxxxxxxxxxxxxx------E-------------------xx------x-xx
--------xx-----------xxxxxxxxxx--x------------xxXSSSSSSSSSSSS-x-----xx-----------xxxxxxxx--------xx-
xxxx---xx-x-xxxxx---xx-XXXXXEXX---xxx--------xxXX--------------x---xx-x-xxxxx---xx-XXXXXX--------XX-
x---x-xx---xx----x-xx---------X---<>-x------xxXXX----oooooo-----x-xx---xx----x-xx-------------------
-----xx----<>-----xx----------X---[]--x----xxXXXX----------------xx----<>-----xx--------------------
-----<>----[]-----<>----------X---[]---xxxxxXXXXX----oooooo------<>----[]-----<>--------------------
X----[]----[]-----[]----------X---[]---XXXXXXXXXXXXXXXXXXXXXX----[]----[]-----[]--------------------