----------------------------------------------------------------------------------------------------
----------------------------------------------------------------------------------------------------
----------------------------------------------------------------------------------------------------
----------------------------------------------------------------------------------------------------
----------------------------------------------------------------------------------------------------
--------------------------------------------------SSSSSSS---------------E-------E-------------------
E--------------------------------------------------------------------E------------------------------
>----------------------------------------------------------------xxxxxxxxxxxxxxxx-----------<>------
]--------------------------------------------------E--E---------xxXSSSSSSSSSSSSS-x----------[]-xxxx-
X------------------xx-----------------------------SSSSSSS------xxXX---------------x--------QQQxx-X-x
xx----------------xB-x-------------------Q?QQQ----------------xxXXX----ooooooo-----x---------xx--X--
<-x---xxx--------xxb--x------------------------------xxx-----xxXXXX-----------------xxxx----xx---X--
]--xxxxE-xxxxxxxxx-BEE-xxxxxxxxxxxxxxxxxxxxxxxxxxxxxxx--xxxxxxXXXXX----ooooooo-------x--xxxxx----X--
XXXXXXXXXXXXXXXXXXXXXXXXXXXXXXXXXXXXXXXXXXXXXXXXXXXXXX--XXXXXXXXXXXXXXXXXXXXXXXX-----X--XXXXX--XXXXX