----------------------------------------------------------------------------------------------------
----------------------------------------------------------------------------------------------------
------------------------------------------------------------E---------------------------------------
----------------------------------------------------------------------------------------------------
-------------------------------E----------------------------E-----o---------------------------------
----E--------------------------S--------------xxxx---------SQS--SQS----------SSSSQSS<?S-------------
---------------------------------------------xx-X-xxx-----------------------------------------------
xxxxx--------------------------?------------xx--XXXX-x----------------------------------------------
SoSS-x---------------xxxx------------------xx-E-XXXX--x------------------------------X-----------X-E
------x----------QQ-xx-X-x----xxx---------xx--X-XXXX---x---SQS--S?S------E---SSSSSSSSX-----------XSS
-------x-----------xx--X--x--xxX-x-------xxE--X-XXXX----x-------------------------------------------
--------xxxx------xx---X---xxx-X--x-----xx-X--X-XXXX-----x----------------------------------xxxx----
E--------x--xxxxxxx----X----x--X---xxxxxx--X--X-XXXX-----Exxxxxxxxxxxxxxxxxxxxxxxxxxxxxxxxxxx---xxxx
XXXX-----X--XXXXXXX--XXXXXXXXXXXX-XXXXXXX--X--X-XXXX-XXXXXXXXXXXXXXXXXXXXXXXXXXXXXXXXXXXXXXXX---XXXX