--------------------------------------------------
--------------------------------------------------
SSSSSSSSSSSSSSSSSSSSSSSSS-------------------------
[]------------------------------------------------
[]-------------------------XXX--------------------
<>----------------------------------------XXX-----
--------------------------------------------------
-E------------------------------------------------
x---------------------xxxxx-----SSSSS??-----------
-xx-----xxxx---------xxXXX-xxxx-------------------
---xx--xxSS-x-------xxEXXX-XXX-x------------------
--<>-xxx-SS--x-----xxXXXXX------x------xxx--------
--[]--x--SS---xxxxxxXXXXXX-------xxxxxxx--xxxxxxxx
XXXXXXX--XX--XXXXXXXXXXXX-------XXXXXXXX--XXXXXXXX