----------------------------------------------------------------------------------------------------
----------------------------------------------------------------------------------------------------
----------------------------------------------------------------------------SSSSSSSSSSSSSSSSSSSSSSSS
----------------------------------------------------------------------------------------------------
---xxxxx-------------------------------------------------------xxxx---------------------------------
--xxXX--x----------------------------------E---S------xxxx----xxXX-x--------------------------------
-xxXXX---x--------------------------------<>---------xx---x--xxXXX--x-------------------------------
xxXXXX----x-------------------------------[]--------xx-----xxxXXXX---x-----------------------------x
xXXXXX-----x------------------------------[]----xxxxx-------xXXXXX----x------------------------xxxxx
-XXXXX------x---------------SSQS---------SXXS-xxx--<>-------XXXXXX-----x-----------QQQQQ-----xxxXXXX
XXXXXX-------x---------------------xxxx------xx<>--[]-------XXXXXX------x------------------xxxXXXXXX
XXXXXX--------xx-------xxx--------xx<>-x----xx-[]--[]-------XXXXXX-------x---------------xxxXXXXXXXX
XXXXXX--------X-xxxxxxxx--xxxxxxxxx-[]--xxxxx--[]--[]-------XXXXXX--------xxxxxxxxxxxxxxxxXXXXXXXXXX
XXXXXXXXXXXXXXXXXXXXXXXX--XXXXXXXXXXXXXXXXXXXXXXXXXXXXX-----XXXXXXXXXXXXXXXXXXXXXXXXXXXXXXXXXXXXXXXX