----------------------------------------------------------------------------------------------------
----------------------------------------------------------------------------------------------------
SSSSSSSSSSSSSSSSSSSSSSSSSSSSSSS?SSSS-SSSS-----------------------------------------------------------
SSSS---SSSS------SSSS-------------------------------------------------------------------------------
SSSS---SSSS--E---SSSS-------------------------------------------------------------------E-----------
-S-S----S----SS----------ooooooo---------------E----------------------xxxxxx--------SSS-------E-----
-S-S----S----SS-------------------------------<>--------------SSSS---xx-<>--x----------------<>-----
-S-S----S----SS----------SSSSSSS--------------[]--------------------xx--[]-X-x---------------[]-----
oSoS----So??-SS---E------SSSSSSS--------------[]----xxx-----------xxx---[]-X--x--------------[]-----
SSSS----SSS--SS--SSSS-------------------X-----XXX--xx--x---------xx<>--QQQ?X---x-------------[]-----
----------------EE---------------------XX-----X---xx----x-------xx-[]------X----x-------------------
-o------------------xxxxx-------------XXX--------xx------------xx--[]------X-----x------------------
xxxxxxxxxxxxxxxxxxxxx----xxxxxxxxxxxxxxxxxxxxxxxxx------Xxxxxxxx---[]------X-]----xxxxxxxxxxxxxxxxxx
XXXXXXXXXXXXXXXXXXXXX---XXXXXXXXXXXXXXXXXXXXXXXXXXX-----XXXXXXXXXXXXXX-----XXXXXXXXXXXXXXXXXXXXXXXXX