----------------------------------------------------------------------------------------------------
----------------------------------------------------------------------------------------------------
-SSSSSSSSSSSSSSSSSSSSSSSSSSESSSSS]---SSSSSSSSSSSSSSSSSSSSSSSSSSSSSSSSSSSSSSSSSSSSSSSSSSSSSSSSSSSSSSS
SSS---------SSSSSSSSSSSSS-->----[]----------------------------------------------SSSSSSSSSSS---------
SSS---------SSSSSSSSSSSSS--]----[]-------E--------------xxx---------------------SSSSSSSSSSS---------
SSS------oooSSSSSSSSSSSSS--XXX--[]---QQQQQQ-------xxxxxxx--x--------------------SSSSSSSSSSS?--------
------------SS--S----S-S--------[]---------------xxSSSSSS---xxxxx-----------------------------------
-------S-SSSSS--S----S-S--------[]--------------xx-SSSSSS--SSSSS-x----------------------------------
x------SoS--SS--So??-SoS?-------[]--xxxxxxxxxxxxx--SSSSSS--SSSSS--xxxxxxxxxxxxxxxxxxxxxxxx--------xx
-xx----SSS--SS--SSS--SSSS-------[]-xxSSSSSSSSSSSS--SSSSSS--SSSSS?SS?SSSSSS????S?SSSSSSSSS-xxx----xx-
SS-x----------------------------<>xx-SSSSSSSSSSSS------------------SSSSSSSSSSSXS---------SSS-x--xx--
SS--x-------------------xxx------xx--SSSSSSSSSSSS--------<>--------SSSSSSSSSSS-S---------SSS--xxx---
--E--xxxxxxxxxxxxxxxxxxxx--xxxxxxx---SSSSSSSSSSSS--------[]------------------------------------x----
XXEXXXXXXXXXXXXXXXXXXXXXX--XXXXXXX---XXXXXXXXXXXXXXXXXXXXXXXXXXXXXXXX-XX-X-XXXXXXXXXXXXXXXXXXEXX----