----------------------------------------------------------------------------------------------------
----------------------------------------------------------------------------------------------------
----------------------------------------------------------------------------------------------------
----------------------------------------------------------------------------------------------------
----------------------------------------------------------------------------------------------------
----------------------S-------------------------------------------------------QQQQ------------------
-----------------------------------oooo----------oooo-------------ooo]------------------------------
----------------------------------------------------------------------------------------------------
---------------------------------------------xxxx-------------xxxx----------------------------------
?-------------------QQQQ--------xxx---------xx<>-x-----------xx<>-x---------QQ?SSQQQ----------------
QS-----------------------------xxX-x-------xx-[]--x---------xx-[]--x-------------------------xxxx---
X-------xxxx------------------xx-X--x-----xx--[]---x-------xx--[]---x---------xxx-----------xx<>-x--
xxxxxxxxx---xxxxxxxxxxxxxxxxxxx--X---xxxxxx---[]----xxxxxxxx---[]----xxxxxxxxxx--xxxxxxxxxxxx-[]--xx
XXXXXXXXX---XXXXXXXXXXXXXXXXXXXXXXXXXXXXXXXXXXXXXXXXXXXXXXXXXXXXXXXXXXXXXXXXXXX--XXXXXXXXXXXXXXXXXXX