----------------------------------------------------------------------------------------------------
----------------------------------------------------------------------------------------------------
----SSSSSSSSSSSSSS--SSSSSSSS[SS[SSSSSSSS---------------------------------------S--------------------
-------------SSS----SSSSSSSS[SS-SSSSSSSS----------------------XXXXXXXXX-XXXXX--S--------------------
-------------SSS----SSSSSSSS[SS-SSSSSSSS---------------------XX----------------S------------------xx
-------------SSS----SSSSSSSS[SSESSSSSSSS--------------------XXX----------------S--------------xxxxx-
----------------------------<SS>SSSSSSSS------------------XXXXX----------------S-------------xxXXXX-
----------------------------[SS]SSSSSSSS-----------------XXXXXX----------------S------------xx------
-------------xxx----xxxx----]SS]SSSSSSSS----------E-----XXXXXXX----------------S--------xxxxx-------
------------xx--x--xx-SSxxxx]SS]SSSSSSSS-E-------<>----XXXXXXXX----------------S-------xx-XXX-------
xxxxx------xx----xxx--SSSSSSSSSSSSSSSSSS<>-------[]---XXXXXXXXX---<>----<>-----S------xx------------
x>---x----xx------x---SSSSSSSSSSSSSSSSSS[]---<>--[]--XXXXXXXXXX---[]----[]-----S-----xx-------------
>]----xxxxx------<>---SSSSSSSSSSSSSSSSSS[]---[]--[]-XXXXXXXXXXX---[]----[]-----Sxxxxxx--------------
XXX--XXXXXX------[]---XXXXXXXXXXXXXXXXXXXXXXXXXXXXXXXXXXXXXXXXXXXXXXXXXXXXXXXXXSxXXXXX--------------