-----------------------------------------------------------------------------------------------[-]--
----------------------xxxxxxxxxxxxxxxxxxxxxxxxx--------------------------------------------xxxx[-]--
S]-------------------xx-SSSSSSSSSSSSSSSSSSSSSS-x---SSSSSSSSSSSSSSSS--------------SS--[]SSSSSSSSSSSSS
[]------------------xx--------------------------x--SSSS------------------------------[]SSSSSSSSSSSSS
[]--------xxxxxxxxxxx----------------------------x-SSSS------------------------------[]SSSSSSSSSSSSS
[]-------xx--QQQ?QQQ------------------------------xSSSS-------------xx--xxxxx--------[]SSSSSSSSSSSSS
[]------xx-----------------------------------------x---------------xx-xxx----x-------[]SSSSSSSSSSSSS
[]-----xx------E------------------------------------x-------------xx--XXX-----x------[]SSSSSSSSSSSSS
[]---xxx-----SSSSSSS---------------E----------------oxxx------xxxxx------------x------]SSSSSSSSSSSSS
[]--xx<>-----------------------E--<>---------------S?SS-x----xx-XXX-------------xxxxx-]SSSSSSSSSSSSS
[]-xx-[]-------X--------------<>--[]---------E-----SSS---x--xx-----------SSS-S--SSSSSS]SSSSSSSSSSSSS
<]xx--[]-------X-------<>-----[]--[]--------<>-----SS-----xxx------------SSS-S--SSSSSSSSSSSSSSSSSSSS
x]x---[]----E--X-------[]---E-[]--[]--------[]-------E-EE--xX------------SSS-S--SSSSSSSSSSSSSSSSSSSS
X>XXXXXXXXXXXXXXXXXXXXXXXXXXXXXXXXXX--XXXXXXXXXXXXXXX--XXXXXX---------XXXSSS-S--XXXXXXXXXXXXXXXXXXXX