----------------------------------------------------------------------------------------------------
----------------------------------------------------------------------------------------------------
--------------------------------------------------E-------------------------------------------------
----------------------------------------------------------------------------------------------------
-----------------------------------------------------------------------------------------xx---------
-----SS-------------SSS------------xxxxx-------SSS?SSS-------xxxxx-------------------SS-xx-xx-------
----------------------------------xx-<>-x-------------------xx-<>-x--------------------xx-<>-x-----x
---------------------------------xx--[]--x-----------------xx--[]--x--------------xxxxxx--[]--x---xx
--------------xxxxx------------xxx---[]---x--------------xxx---[]---x------------xx---x---[]---x-xx-
----SSS---xxxxx-XX-xSSS-------xx<>--QQQ?-E-x------------xx<>--QQQ?S--x----------xx----SS--[]----xx--
---------xxXX<>-XX--x--------xx-[]------<>--x----------xx-[]----------x-------xxx---------[]----<>--
xxx-----xxXXX[]-XXX--x------xx--[]------[]---x------E-xx--[]-----------x-----xx<>---------[]----[]--
---xxxxxxXXXX[]-XXX---xxxxxxx---[]------[]----xxxxxxxxx---[]------E-----xxxxxx-[]--E------X]----[]--
X-XXXXXXXXXX-XXXXXXXXXXXXXXXXXXXXXXXXXXXXXXXXXXXXXXXXXXXXXXXX-----X---XXXXXXXXXXXXXXXXXXXXXXXXXXXXXX