------------x---------------------------------------------------------------------------------------
----------------------------------------------------------------------------------------------------
oSSSSSSSSSSS-------SSx------------------------------------------------------------------------------
-SS-------[]----------------------------------------------------------------------------------------
SSS-------[]----------------------------------------------------------------------------------------
SSS-------[]----------------SSSSSSS----------XXXXXXXXXXXXXXXX----------------X----------------------
S---------[]-------------------------------------[]-------[]----------------------------------------
Sx--------[]-----------xxx--------xxx------------[]-------[]----------------------------------------
S-xx------[]----xxx---xxB-xxxxxxxxx--x-----------[]-------[]-------xxx----X------X------------------
x<>-x-----[]---xx--x-xxXXXXESSSSSSS---x----------[]-------[]------xx<-x----------ooo----------------
-[]--x----<>--xx----xxXXXXXX-----------x---------<>-------<>-----xx-[]-x----------------------------
-[]---x-----x-x-----XXXXXXXX------------x--------xxx------xxx---xx--[]--x----------xxx----xxxx------
-[]----xxxxxx------XXXXXXXXX-----------B-xxxxxxxxxE-xxxxxxxE-xxxx---[]---xxxxxxxxxxx--xxxxxEE-xxxxxx
XXXXXEXXXXXXXx-----XXXXXXXXXXXXXXXXXEXXXXXXXXXXXXXX-XXXXXXXX-XXXXX--XXXXXXXXXXXXXXXX--XXXXXXXXXXXXXX