----------------------------------------------------------------------------------------------------
-----------------------------------------xxx--------------------------------------------------------
----------------------------------------xx--x-------------------------------------------------------
---------------------------------------xx----xx-----------------------------------------------------
--------------------------------------xx-----E-xxxxxx-----------------------------------------------
--------------<-------S----S--------xxx---------x----x-------SSSSSSS-xx------------?----E-E-E-------
-----------------------------------xx-S--------<>-----x-------------xx-x---------------<><><>-------
----------------------------------xx-----------[]------xxxx--------xx---xxx------------[][][]-------
---------------------xxxx--------xx------------[]-------xB-xxxxxxxxx----<>-x---Q--Q----QQQQQQ-------
E-------------------xx<>-x------xx-------X-----XX-------XXXXESSSSSS?----[]--x-----------------------
---X---------------xx-[]--x----xxE---------------------XXXXXX-----------[]---x----------------------
SSSX--------------xx--[]---x--xx<>--------------------XXXXXXX-----------[]----x-----xxx---------xxxx
xxxxxxxxxxxxxxxxxxx---[]----xxx-[]-----X-------------XXXXXXXX-----------[]-----xxxxxx--xxxxxxxxxx---
XXXXXXXXXXXXXXXXXXXXXXXXXXXXXXXXXXXXXXXX-------------XXXXXXXXXXXXXXXX---XXXXXXXXXXXXX--XXXXXXXXXX---