----------------------------------------------------------------------------------------------------
-------------------------------------------------------------------------------------------xxx------
------------------------------------------------------------------------------------------xx--x-----
-----------------------------------------------------------------------------------------xx----xx---
-----------------------------------------xxx--------oo----------------------------------xx-----E-x--
----------------------------------------xx--x-----------------------------------------xxx---------x-
---------------------------------------xx----x------------------------------ES-------xx-S--------<-x
--------------------------------------xx------x-------------------------------------xx-----------[--
--------------------------------o---xxx--o-----xxx----------------------E----------xx------------X--
xx--------------------xxxx---------xx<>--------<>-x---------------x---------------xx-------X------XX
X-x------------------xx<>-x-------xx-[]--------[]--x-----xxxx--------------------xx-----------------
]--x----------------xx-[]--x-----xx--[]--------[]---x---xx<>-x------------------xx<>----------------
]--Exxxxxxxxxxxxxxxxx--[]---xxxxxx---[]--------[]-E-Exxxx-[]-Exxxxxxxxxxxxxxxxxxx-[]-----X----------
XXXXXXXXXXXXXXXXXXXXXXXXXXXXXXXXXXXXXXXXXXXXXXXXXXXXXXXXXXXXXXXXXXXXXXXXXXXXXXXXXXXXXXXXXX----------