--------------xxx-----------------------------------------------------------------------------------
xxxxxxxxxxxxxxx--x----------------------------------------------------------------x-----------------
XXXXXXXXXXXXXXX---x------SSSS]S--SSSSSSSSSSS------SSS--[]SSSSSSSSSS?SSSSX--------------SSSSSSSSSSSSS
XXXXXXXXXXXXXXX----x--------[]---SSSSSSSSSSS-----------[]SSSSSSSS---SSSS---------------------[]-----
XXXXXXXXXXXXXXX-----x-------[]---SSSSSSSSSSSx----------[]SSSSSSSSE--XSSS---------------------[]-----
XXXXXXXXXXXXXXX------x------[]---SSSSSSSSSSS-x---------[]SSSSSSSSSSSSSSSS----------x---------[]-----
XXXXXXXXXXXXXXX-------x-----[]---SSSSSSSSSSS--xx-------[]SSSSSSSSSSSSSSSS-----------x--------[]-----
XXXXXXXXXXXXXXX--------x---------SSSSSSSSSSS--S-x------[]SSSSSSSSSSSSSSSS------------x-------[]-----
XXXXXXXXXXXXXXX---------x--------SSSSSSSSSSS-oS--x------]SSSSSSSSSSSSSSSS----------S--x------[]---xx
XXXXXXXXXXXXXXX----------xxxxxxxxxxxxxSSSSSS-SS---xxxxx-]SSSSSSSSSSSSSSSS--------E-----xx----[>--xx-
XXXXXXXXXXXXXXX----------SSSSSSSSSSSSSSSSSSS------SSSSSSSSSSSSSSSSSSSSSSS---E---<>-----S-x---<--xx--
XXXXXXXXXXXXXXX----------SSSSSSSSSSSSSSSSSSS------SSSSSSSSSSSSSSSSSSSSSSS--<>---[]-----S--x---Exx---
XXXXXXXXXXXXXXX--------------XXSSSSSSSSSSSSS------SSSSSSSSSSSSSSSSSSSSSSS--[]---[]------E--xxxxx----
XXXXXXXXXXXXXXX--XXXXXXXXXXX-XXXXXXXXXXXXXXX------XXXXXXXXXXXXXXXXXXXXXXX--XX---XXXXXXXXEXXXXXXX----