------------------------------------------------------------xxxxxx----------------------------------
------------------------xxxxxxxxxxxxxxxxxxxxxxxxxxxxxxxxxxxxx--XX-xxxxxxxxxxxxxxxxxxxxxxxxxxxxxxxx--
SSSSSSSSSSSSSSS--------xxSSSSSSSSSSSSSSSSSSSSSSSSSSSSSSSSSSSS[----SSSSSSSSSSSSSSSSSSSSSSSSSSSSSSSSx-
SSSSSS---------------xxx-------XX---------------------------------SSSSSSSS-------------------------x
SSSSSS-----------XXX-xx--------E----------------------------------SSSSSSSS--------------------------
SSSSSS--QQ------xxxx-xSSS-----<>----------------------------------SSSSSS----E-----------------------
S--------------xx---xx--------[]----------------------------------S-<------<>-----------------------
-----xxx-xxx--xx-----xS-------[]----------------------------------S-[------[]-----------E-----------
xxxxxx--xx--xxx------S-S------[]------------------E-----------------E------[]----------<>-----------
SSSSSS--QQ--QQQ---------S-----[]-------E------E--<>----------------<>-----?SSS-E-------[]-----------
SSSSSS------------------------<>------<>-----<>--[]---------XX-----[]---------<>-------[]--<>-------
SSSSSS------------------------[]------[]-----[]--[]--------XXXXXX--[]---------[]---<>--[]--[]---<>--
SSSSSS------------------------[]------[]---E-[]--[]-------XXXX-----[]---------[]---[]--[]--[]---[]--
XXXXXXXXXXXXXXX------XXXXXXXXXXXXXXXXXXXXXXXXXXXXXX---XXXXXXX--X--XXXXXXXX----XX---XX--XX--XX--XXXXX