----------------------------------------------------------------------------------------------------
----------------------------------------------------------------------------------------------------
----------------------------------------------------------------------------------------------------
----------------------------------------------------------------------------------------------------
----------------------------------------------------------------------------------------xxxxxxxxxxx-
-------------------------------------------------------------SSS?SSS-------QQ?---------xx--QQQ?QQQ-x
--------------------------------------------------------------------------------------xx------------
x------------------------------------------------------------------------------------xx------E------
-x-------------------------------------------------------------------------SSS-----xxx-----SSSSSSS--
--x-----------------ooo--------------------------------------SSSSSSS------xxxx----xx<>--------------
---x---------------------------------------------------------------------xx---x--xx-[]-------X------
o---x-----xxx---------xxx-----xxxx----------------xxxxx----------xxxxxxxxx-----xxx--[]-------X------
-----xxxxxx--xxxxxxxxxx--xxxxxxEE-xxxxxxxxxxxxxxxxx--E-xxxxxxxxxxx---x--x-------x---[]----E--X------
XXXXXXXXXXX-EXXXXXXXXXX--XXXXXXXXXXXXXXXXXXXXXXXXXX--XXXXXXXXXXXXX-X-X--X-------XXXXXXXXXXXXXXXXXXXX