----------------------------------------------------------------------------------------------------
----------------------------------------------------------------------------------------------------
----------------------------------------------------------------------------------------------------
----------------------------------------------------------------------------------------------------
----------------------------------------------------------------------------------------------------
---ooo--------------------------xxx--------------------------------------------------------EXX------
-------------------------------xxX-x------------------------------------------------------EXXX------
---SSS------------------------xxXX--x--------------xxxxx--------------------E------------EXXXX------
---SSS---xxx-----------------xxXXX---x----------xxxx-<>-x--------------------XXX------X--XXXXX------
xx------xx--x---------------xxXXXX----x--------xxQQ?-[]--x------------------------------XXXXXX------
-------xx----x-------------xxXXXXX-----x------xx-----[]---x----------------------------XXXXXXX------
<>----xx------------------xxXXXXXX------x----xx------[]----x--------------------------XXXXXXXX------
xxxxxxx------XxxxxxxxxxxxxxXXXXXXX-------xxxxx--X----[]-----xxxxxxxxxxxxxxxx---------XXXXXXXXX------
XXXXXXX------XXXXXXXXXXXXXXXXXXXXXXXXXXXXXXXXXXXXXXXXXXXXXXXXXXXXXXXXXXXXXXX--------XXXXXXXXXXXXXXXX