----------------------------------------------------------------------------------------------------
x---------------------------------------------------------------------------------------------------
SSSSSSSSSSSSSSSSSSSSSSSSSSSSSSSSSSSSSSSSSSSSSSSSSSSS------------------------------------------------
S---------------------------------------------------------------------------------------------------
----------------------------------------------------------------------------------------------------
----------------------------------------------oooo-----------------------xx-------------------------
-----------------------------------o------------------------------------xx-x------------------------
-------------------------------xxxxx--------S-SSSS-S-------------------xx---x----oooooo-------------
----------------------------xxxx--S-x-------SoS--SoS---------------xxxxx-----x-----xx---------------
--------------QQQQ--------xxxXXX-----xx-----SSS--SSS----E---------xx--XX------x---xx-x-----------S--
-oo---------------------xxxXXXXXXX--XX-xx-------------------E----xx---XXX------x-xx---x-------------
oxxxx--------------xxx-xxXXXXXXXXX--XXXX-x----------------------xx----XXXX------xx-----xxxx---------
oE---xxxxxxxxxxxxxxxX-xxXXXXXXXXXXE-XXXX--xxxxxxxxxxxxxxxxxxxxxxxX----XXXXX-----<>-----XXX-xxxxxxxxx
X----XXXXXXXXXXXXXXXXXXXXXXXXXXXXXXXXXXXXXXXXXXXXXXXXXXXXXXXXXXXXX----XXXXXX----[]-------XXXXXXXXXXX