----------------------------------------------------------------------------------------------------
----------------------------------------------------------------------------------------------------
------------------------------------------------------------------------SSSSSSSSSSSSSSSSSSSSSSSSSSSS
------------------------------------------------------------------------[[]----[]-------------S-----
------------------------------------------------------------------------[[]----[]-------E-----S-----
---------------------------S--xx--SSSSSS--------------------------------[[]----[]---QQQQQQ----S-----
-----------------------------xx-xxxxx------------------------------------[]----[]------------xx-----
----------------------------xx--XXXX-x-----<>----------------------------[]----[]--------------x----
xxxx----xx-----------xxxxxxxx---------x----[]----------------------------[]----[]--xxxxxxxxxxx--x---
xXX-x--xx-x-xxxxx---xx-XXXXXX----------x--QQQQQQ-----------x-------------<>----[]-xxSSSSSSSSSSSS-xSx
XX---xxx---xx----x-xx-------------------x-------------------x------------------<>xx-SSSSSSSSSS----x-
XX----x----<>-----xx--------------<>-----x-xxxxx---xxx-------x------------------xx--SSSSSSSSSS-----<
E----<>----[]-----<>--------------[]------xx----xxxxE-xxxxxx-Exxxxxxxxxxxxxxxxxxx---SSSSSSSSSS-----[
XX---[]----[]-----[]------------XXXXXXXEXXXX-X-XXXXXXXXXXXXXXXXXXXXXXXXXXXXXXXXXXE--XXXXXXXXXXXXXXXX