----------------------------------------------------------------------------------------------------
-----------------------------------------------------------------------------xxxxxxxxxxxxxxxxxxxxxxx
SSSSSSSSSSSSSSSSSSSSSSSSSSSSSSS-SSSSSSSSSSSSSSSSSSSSSSSSSSSSSSSSSSSSSSSSSSSSSSSSSSSSSSSSSSSSSSSSSSSS
[]----]------------------------------------------SSSSSSSSSSSSSSSSSSSSSSS----------------------------
[]----]----------------xxx-----------------------SSSSSSSSSSSSSSSSSSSSSSS----------------------------
[]---QQQQ-------xxxxxxxx--x----------------------SSSSSSSSSSSSSSSSSSSSSSS-----------------E----------
[]-------------xxSSSSSSS---xxxxxx----------------------<>-------------------------------<>----------
[]------------xx-SSSSSSS--SSSSSS-x---------------------[]-------------------------------[]----------
[]--xxxxxxxxxxx--SSSSSSS--SSSSSS--xxxxxxxxxxxxxxxxxxxxx[]--oooo--oo--------------------o[]------S---
[]-xxSSSSSSSSSS--SSSSSSS--SSSSSS?SS?SSSSSS???????SSSSSSSSSS?SSS--SS-----XX---------E--SS[]S---E----E
<>xx-SSSSSSSSSS--------------------SSSSSSSSSSSSSS----------------------XXX--<>----<>----[]---<>---<>
-xx--SSSSSSSSSS---------<>---------SSSSSSSSSSSSSX---------------------XXXX--[]----[]----[]---[]---[]
xxE--SSSSSSSSSS---------[]--------------------------------------E----XXXXX--[]----[]-E--[]---[]---[]
XXX--XXXXXXXXXXXXXXXXXXXXXXXXXXXXXXXX-XXX-XXXXXXXXXXXXXXXXXXXXXXXXXXXXXXXXXXXXXXXXXXXXXXXXXXXXXXXXXX