----------------------------------------------------------------------------------------------------
----------------------------------------------------------------------------------------------------
----------------------------------------------------------------------------------------------------
------------------------------------------------------------------------------------xxx-------------
--------------------------------------------------------------------------xxxx----xxx--x------------
-----------------------------------------------E-E-E------------S--------xx---x--xxXS---x-----------
--xxx-----------------------------------------<><><>--------------------xx-----xxxEX-----x----------
-xxX-x--------------xxxxx---------------------[][][]-------------------xx-------xXXX------x---------
xxXX--x----------xxxx-<>-x--------------------QQQQQQ--------------xxxxxx--------XXXXS------x--------
xXXX---x--------xxQQ?-[]--x----------------------------------Q--xxx---<>-------XXXXX--------x-------
XXXX----x------xx-----[]---x----------------------------xxxx---xx<>---[]------XXXXXX---------x------
XXXX-----x----xx------[]----x--------------------------xx<>-x-xx-[]---[]-----XXXXXXX----------x-----
XXXX------xxxxx--X----[]-----xxxxxxxxxxxxxxxxxxxxxxxxxxx-[]--xx--[]---[]----XXXXXXXX---------X-xxxxx
XXX--XXXXXXXXXXXXXXXXXXXXXXXXXXXXXXXXXXXXXXXXXXXXXXXXXXXXXXX-XXX-XX--XXXXX-XXXXXXXXXXXXXXXXX-XXXXXXX