--------------------------------------------------
--------------------------------------------------
-----[]SSSSSSSSSSSSSSSSSSSSSSSSSSSS---------------
-----[]SSSSSSSSSSSSSSSSSSSSSSSSSSSS---------------
-----[]SSSSSSSSSSSSSSSSSSSSSSSSSSSS---------------
-----[]SSSSSSSSSSSSSSSSSSSSSSSSSSSS---------------
-----[]SSSSSSSSSSSSSSSSSSSSSSSSSSSS---------------
-----[]SSSSSSSSSSSSSSSSSSSSSSSSSSSS---------------
------]SSSSSSSSSSSSSSSSSSSSSSSSSSSS--------------X
xxxxx-]SSSSSSSSSSSSSSSSSSSSSSSSSSSS--------E----XX
SS-SSSSSSSSSSSSSSSSSSSSSSSSSSSSSSSS---E---<>---XXX
SS-SSSSSSSSSSSSSSSSSSSSSSSSSSSSSSSS--<>---[]--XXXX
S--SSSSSSSSSSSSSSSSSSSSSSSSSSSSSSSS--[]---[]-XXXXX
XXXXXXXXXXXXXXXXXXXXXXXXXXXXXXXXXXX--XX---XXXXXXXX