----------------------------------------------------------------------------------------------------
----------------------------------------------------------------------------------------------------
----------------------------------------------------------------------------------------------------
----------------------------------------------------------------------------------------------------
----------------------------------------------------------------------------------------------------
S---------------------------------------------------------------------------------------------------
----------------------------------------------------------------------------------------------------
----------------------------------------------------------------------------------------------------
x------------oo-----------------------------------------xxxx--------------------------xx-----------x
-x----------xxxx--------------------xxx-------xxx------xx<>-x-----------------xxxx---xx-x-xxxxx---xx
--x--------xx---x---------xxxx-----xxS-x-----xxX-x----xx-[]--x----QQQQQ?-----xx---x-xx---xx----x-xx-
---x------xx-----x-------xx<>-x---xx-S--x---xx-X--x--xx--[]---x-------------xx-----xx----<>-----xx--
o---xxxxxxx-------xxxxxxxx-[]--xxxx--S---xxxx--X---xxx---[]----xxxxxxxxxxxxxxX-----<>----[]-----<>--
XXXXXXXXXXX------XXXXXXXXXXXXXXX<>XX-XXXXXXXXXXXXXXXXXXXXXXXXXXXXXXXXXXXXXXXXX-----[]----[]-----[]--