----------------------------------------------------------------------------------------------------
-------------------------------------------------------------------xxx------------------------------
------------------------------------------------------------------xx--x-----------------------------
-----------------------------------------------------------------xx----xx---------------------------
-------xxxx----xxxxx---------------------------------------------x-----E-xxxxxx---------------------
------xx---x--xxXXX-x-------------------xxxx------------------xxxS--------x----x----xxxxx-----------
-----xx-----xxx-XXX--x-----------------xx---x-----xxxx-------xx--x-------<>-----x--xxXXX-x----------
----xx-------xXXXXX---x---------------xx-----x---xx---x-----xx-----------[]------xxxXXXX--x---------
--xxx--------XXXXXX----x----------xxxxx-------x-xx-----x---xx------------[]-------xXXXSS---x--------
-xx<>-------XXXXXXX-----x--------xx-XXX--------xx-------x-xx-------X-----XX-------XXXXXX----x-------
-x-[]------XXXXXXXX------x------xx-------------<>--------xx--S----XX-------------XXXXXXX-----x------
xx-[]-----XXXXXXXXX-------x----xx----------ES--[]--------<>--S---XXX------------XXXXXXXX------x----x
x--[]----XXXXXXXXXX--------xxxxx----------<>---[]--------[]-----XXXX-----------XXXXXXXXX-------xxxxx
XXXXXXXXXXXXXXXXXXXXXXXXXXXXXXXX----------[]---[]--------XXXXXXXXXX------------XXXXXXXXXXXXXXXXXXXXX