--------------------------------------------------
--------------------------------------------------
--------------------------------------------------
--------------------------------------------------
------------------------------------------------E-
----------------------------------------------SSSS
------xxxx----------------------------------------
E----xx---x----------------------------------E----
----xx-----xxx-------xxxx----S--------------------
--xxx------<>-x-----xx<>-x-----------------S?S----
-xx<>------[]--x---xx-[]--x-----------------------
xx-[]------[]---x-xx--[]---x-----xxx--------------
x--[]-E----[]----xx-E-[]----xxxxxx--xxxxxxxxxxxxxx
XXXXXXXXXXXXXXXXXXXXXXXXXXXXXXXXXX--XXXXXXXXXXXXXX