--------------------------------------------------
--------------------------------------------------
SSSSSSSSSSSSS------SSSSSSSSSSSSS--------------SSSS
-------------------------------xxx----------------
xxxxxx------------------------xx--x---------------
x-----x-------------------xxxxx----x--------------
x------x-----------------xxXXXX-----x-------------
S-------x----------------xXXXXX------x------------
---E-----x------xxx-----xXXXXXX-------x-----------
--<>------xxxxxxx--x---xxXXXXXX-----S--x----------
--[]------SSSSXSS--Sx-xxXXXXXXXX--------x---------
--[]------SSSSX------xxXXXXXXXXX---------xx-------
E-[]----------X------XXXXXXXXXXX---------X-xxxxxxx
XXXXXXXXXXXXX-X------XXXXXXXXXXXXXXXXXXXXXXXXXXXXX