----------------------------------------------------------------------------------------------------
----------------------------------------------------------------------------------------------------
----------------------------------------------------------------------------------------------------
----------------------------------------------------------------------------------------------------
----------------------------------------------------------------------------------------------------
----------------------------------------------------------------------------------------------------
-----------------------------------------------------------------E----------------------------------
----------------------------------------------------------------<>----------------------------------
------------------------------------------------------xxxxxx----[]---------------?-----Exxx---------
E--------------------------------xxx-----------------xxXSSS-x---XX---------------------xxX-x--------
>-------------------------------xxX-x---------------xx-X-----x--------xxxx------------xx-X--x-------
]-----------?----x-xxxx-------Exx-X--x-------------xx--X------x----B-xx<>-x---B--E---xx--X---x------
]-------E---------xx---xxxxxxxxx--X---xxxxxxxxxxxxxxE-EX-------xxxxxxx-[]--xxxxxxxxxxx---X----xxxxxx
XXXXXXXXXXXX-XXXXXXX---XXXXXXXXX--XXXXXXXXXXXXXXXXXXXXXXXXXX---XXXXXXXXXXXXXXXXXXXXXXX---XXXXXXXXXXX