----------------------------------------------------------------------------------------------------
----------------------------------------------------------------------------------------------------
----------------------------------------------------------------------------------------------------
----------------------------------------------------------------------------------------------------
----------------------------------------------------------------------------------------------------
---------------------------------------------------SSSSSSS------------xxxxxxx------E----------------
-x-------------------------------------------------------------------xxXX<>X-x----------------------
--------------------------------------------------------------------xx---[]---x---E-----------------
--------------------->------------------------------E--E-----------xx-----]----x--------------------
-Q---X---------------]-----------------------------SSSSSSS------xxxx----------E-x-------------------
-----X---------------]--------------------Q?QQQ----------------xxXXXXXXX-----<>--x-------------?QQ--
-SSSSX---------------------xxx------------------------xxx-----xxXXXX---------[]---x-----------------
xxxxxxxxxxxxxxxxxxxxxxxxxxxxE-xxxxxxxxxxxxxxxxxxxxxxxxx--xxxxxxXXXX----------[]----x----xx-B--------
XXXXXXXXXXXXXXXXXXXXXXXXXXXXXXXXXXXXXXXXXXXXXXXXXXXXXXX--XXXXXXXXX-----------[]-E---xxxxx-xxxxxxxxxx