----------------------------------------------------------------------------------------------------
------------------------xxxxxxxxxxxxxxx-------------------------------------------------------------
---[]SSSSSSSSSSSSS-----SSSSSSSSSSSSSSSS------------------------------------------SSSSSSSSSSSSSSSSSSS
---[]SSSSSSSSSSSSS-----------------------------------------------------------------[]----[]---------
---[]SSSSSSXSSSSSS--------------------------------------------------xxx------------[]----[]-------E-
---[]SSSSSSSSSSSSS-------------------------------------------------xx--x-----------[]----[]---QQQQQQ
---[]SSSSSSSSSSSSS------------------------------------------------xx----x----------<>----[]---------
---[]SSSSSSSSSSSSS-----------------------------------------------xx------x---------------[]---------
----]SSSSSSSSSSSSS----------------E----------------------------xxx--o-----x--------------[]--xxxxxxx
xxx-]SSSSSSSSSSSSS----E----------<>----------------------------x<>---------x-------------[]-xxSSSSSS
SSSSSSSSSSSSSSSSSS---<>----------[]--SS-----------------------xx[]----------x------------<>xx-SSSSSS
SSSSSSSSSSSSSSSSSS---[]----X-XX--[]--SS----------------------xx-[]-----------x----xxx-----xx--SSSSSS
SSSSSSSSSSSSSSSSSS---[]-----o----[]--SSxxxxxxxxxxxxxxxxxxxxxxx--[]----------X-xxxxx--xxxxxx---SSSSSS
XXXXXXXXXXXXXXXXXXE--[]-----o----XX--XXXXXXXXXXXXXXXXXXXXXXXXXXXXXXXXXXXXXXXXXXXXXX--XXXXXXE--XXXXXX