----------------------------------------------------------------------------------------------------
----------------------------------------------------------------------------------------------------
----------------------------------------------------------------------------------------------------
----------------------------------------------------------------------------------------------------
----------------------------------------------------------------------------------------------------
-------------------------------E--S---SSSSSSSSS------------SS---SS-----E----------------E------SS---
------------------------------<>--------------------------------------->---------------<>-----------
------------------------------[]---------------------------------------]----------------------------
------xxxxx--------------------]------------xxxx---------SS------------]----xxxx--------------------
----xxx----x-----------------SSXS----------xx--xxx-xxx---------SSS---xxxxxxxx---x-----------E-SSS---
---xx<>-----xx---------xxxx------xxxx-----xx------xx--xxx-----------xxXXXXXXX----x---------<>-------
B-xx-[]----<>-x---B---xx<>-x----xx<>-x---xx-------<>--<>-x-xxxxx---xxXXX-------------------[]-------
xxx--[]-E--[]--xxxxxxxx-[]--xxxxx-[]--xxxx--------[]--[]--xx----xxxxXXXX---------Xxxxxxxxxxxxxxxxxxx
XXXXXXXXXXXXXXXXXXXXXXXXXXXXXXXXXXXXXXXXXX------XXXXXXXXXXXX-X-XXXXXXXX----------XxXXXXXXXXXXXXXXXXX