----------------------------------------------------------------------------------------------------
----------------------------------------------------------------------------------------------------
----------------------------------------------------------------------------------------------------
----------------------------------------------------------------------------------------------------
--------xxxx------------------------------------xxxxxxxxxxx----------E-E------------------xxxxx-----
-------xx---x-------------E--------------------xx--QQQ?QQQ-x-------SSSSSSS-SS-xxxx-----xxxx--X-x----
------xx-----x-----------<>-------------------xx------------x-------------E--xx---x---xx--E--X--x---
-----xx-------x----------[]------------------xx------E-------x--------------xx-----x-xx---XX-X---x--
x---xxX--------x---------[]-----------xx---xxx-----SSSSSSS----x-----------xxx-------xx----XX-X----x-
-xxxxXX---------xxxxx----[]SSSSSS-----SS--xx<>--------------E--x---------xx<>-------<>----XX-X-----x
---xXXX---------XXXX-x-------------------xx-[]-------X------X---x---E---xx-[]-------[]----XX-X------
E-XXXXX---------XXXXX-x---Exxx--------B-xx--[]-------X------X----x-----xx--[]-------[]----XX-X------
>-XXXXX---------XXXXXX-xxxxxE-xxxxxxxxxxx---[]----E--X------X-----xxxxxx---[]-------[]----XX-X------
XXXXXXX---------XXXXXXXXXXX<>XXXXXXXXXXXXXXXXXXXXXXXXXXXXXXXXXXXXXXXXXXXXXXXX-------XX-XXXXX-XXXXXXX