--------------------------------------------------------------xxx-----------------------------------
--------------------------------------------------xxxxxxxxxxxxx--x-----x----------------------------
SSSSSSSSSSSSSSSSSSSSSSSSSSSSSSS-SSSSSSSSSSSSSSSSSSSSSSSSSSSSSSS---x-----SSSSSSSSSSSSSSSSSSSSSSSSSSSS
[]----------------------------------------------------SSSSSSSSS----x--------------SSSSSSSSSSSSSSSSSS
[X-X------------------------------------------------X-SSSSSSSSS-----x-------------SSSSSSSSSSSSSSSSSS
[---------------------------------------------------SESSSSSSSSS------x------------SSSSSSSSSSSSSSSSSS
>---------------------------------------------------S>SSSSSSSSS-------x-----------------------------
-----xxx--------------------------------------------S]SSSSSSSSS--------x-----------------xxxxx------
xxxxxx?-xxxxxxxxxxxxxxxxxxxxxxxxxxxxxxxxx--xxxxxxx--S]SSSSSSSSS---------xxxxxxxxxxxxxxxxxx----xxxxxx
SSSSSS??SSSSSSSS??S????????SSSSSSESSSSSSS??SSSSSS-x-S]SSSSSSSSS-------SSSSSS??????SSSSSSS?----SSSSSS
SSSSS---SSSSSSSSSSSSSSSSSSSSSSSSSSSSSSSSSSSSSSSSSSSSSSSSSSSSSSS----E--SSSSSSSSSSSS------------------
SSSSS---SSSSSSSSSSSSSSSSSSSSSSSSSSSSSSSSSSSSSSSSSSSSSSSSSSSSSSS---<>--SSSSSSSSSSSS---------<>-------
-----oooSSSSSSSSSSSSSSSSSSSSSSSSSSSSSSSSSSSSSSSSSSSSSSSSSSSSSSS---[]-----------------------[]-------
XXXXXXXXXXXXXXXXXXXXXXXXXXXXXXXXXXXXXXXXXXXXXXXXXXXXXXXXXXXXXXXX--XXXXXXX-X-XXXXXXXXXXXXXXXXXXXXXXXX