--------------------------------------------------
--------------------------------------------------
--------------------------------------------------
--------------------------------------------------
-------oo-----------------------------------------
--------------------------------------------------
x-------------------------------------------------
-x------------------------------------------------
--xxx---------------------------------------------
--<>-x----------------------------------xxxx------
--[]--x-----xxxx-----------------------xx<>-x-----
--[]---x---xx<>-x---------------------xx-[]--x----
--[]-E-Exxxx-[]-Exxxxxxxxxxxxxxxxxxxxxx--[]---xxxx
XXXXXXXXXXXXXXXXXXXXXXXXXXXXXXXXXXXXXXXXXXXXXXXXXX