----------------------------------------------------------------------------------------------------
----------------------------------------------------------------------------------------------------
---------------------------------------xx-----------------------------------------------------------
--------------------------------------xx------------------------------------------------------------
-------------------------------------xx--x---------xxxxx--------------------------------------------
-------------------------------------xS---x-----xxxx--X-x------------------QQQQ---------------------
-------------------------------------x-----x---xx--E--X--x------------------------------------------
-------------------------------------x------x-xx---XX-X---x-----------------------------------------
x-----------------------------------xx-------xx----XX-X----x-------xxxx-----------------------------
-x---------------------xxxx--------xxX-------<>----XX-X-----x----xxx<>-x--E?QQQ----------xxx-----S--
--xx------------------xx<>-x------xx-X-------[]----XX-X------x----x-[]--x---------------xxX-x-------
-->-x----------------xx-[]--x----xx--X-------[]----XX-X-------x-----[]---x------------Exx-X--x------
-<]-Exxxxxxxxxxxxxxxxx--[]---xxxxxE--X-------[]----XX-X-------Exxx--[]----xxxxxxxxxxxxxx--X---xxxxxx
XXXXXXXXXXXXXXXXXXXXXXXXXXXXXXXXXXXXXXXXX----XX-XXXXX-XXXXXXXXXXXXXXXXXXXXXXXXXXXXXXXXXX--XXXXXXXXXX