----------------------------------------------------------------------------------------------------
----------------------------------------------------------------------------------------------------
-----------------------------xx---------------------------------------------------------------------
----------------------------xx----------------------------------------------------------------------
---------------------------xx--x--------------------------------------------------------------------
-----------------------xxxxx----x-------------S---------------------------xSSSS---------------------
----xxxx--------------xxXSSS-----x------------------------xxxxx------------x---xxxxxxxxxx-----------
---xxXX-x------------xxXXX--------x----------------------xxXSS-xo-----------x-xxXXXXXXXX-x----------
--xxXXX--x----------xxXXXS---------x---ooo--------------xxXXX---x------------xxXXXXXXXX---x----xx---
-xxXXXX---x--------xxXXXXX----------xxx-------S--------xxXXXX-SS-xx-----------XXXX---------x--xx-x-x
xxXXXXX----x------xx-XXXXX-SSS------<>-x--------------xxXXXXX----Q-x---------XXXXX----------xxx---xx
xXXXXXX-----x----xx-XXXXXX----------[]--x------------xxXXXXXX--SS-S-x-------XXXXXX-----------x----<>
XXXXXXX------xxxxx-XXXXXXX----------[]---xxxxxxxxxxxxxXXXXXXX--------xxxxxxXXXXXX----<>-----<>----[]
XXXXXX--XXXXXXXXXXXXXXXXXXXX---XXXXXXXXXXXXXXXXXXXXXXXXXXXXX-------XXXXXXXXXXXXXX----[]-----[]----[]