----------------------------------------------------------------------------------------------------
----------------------------------------------------------------------------------------------------
----------------------------------------------------------------------------------------------------
----------------------------------------------------------------------------------------------------
--xxxxxx----------------------------------------------------------------------------------------Eooo
-xx-SSS-x-----------------------------------SSS-----------------------------XXX-----------------XXXX
xx-------x------------------------------------------------------------------------------------------
x-----------xx------------------------------------------------xxx-----------------------------------
>----E-----xx-x-------S-------------------xxxxxxx-----------xxx------S--?--------------------xxxxxxx
]---SSS---xx---xxx--------------------E--xxXXXXX-x---------xx<>--x--------------------------xxXXXXXX
]---------x----<>-x-------------------E-xx-X------x-------xx-[]---x------------------------xx-------
]--------xX----[]--x------xxx----------xx--X-------x-----xx--[]----x-----xxx---------xxxxxxx--------
]--------XX----[]---xxxxxxx--xxxxxxxxxxx---X----SS--xxxxxx---[]-----xxxxxx--xxxxxxxxxx--XXXX--------
X-XXXXXXXXXXXXXXXXXXXXXXXXX--XXXXXXXXXXXXXXXXX----XXXXXXXXXXXXXXXXXXXXXXXX--XXXXXXXXXX--------------