----------------------------------------------------------------------------------------------------
----------------------------------------------------------------------------------------------------
----------------------------------------------------------------------------------------------------
----------------------------------------------------------------------------------------------------
-----------------------------------------------------xxxx-------------------xxx---------------------
---SSSSS-------------xxxxx--------------------------xxXX-x-----------------xx--x--------------------
--------------------xx-<>-x------------------------xxXXX--x---------------xx----x-------------------
--xxxx-------------xx--[]--x----------------------xxXXXX---x-------------xx------x------------------
xxx---xx---------xxx---[]---x--------------------xxXXXXX----x----------xxx--o-----xxx---------------
x-S--<>-x-------xx<>--QQQ?---x------------------xxXXXXXX-----x--------xx<>--------<>-x--------------
>----[]--x-----xx-[]----------x-------xxxx-----xxXXXXXXX------x------xx-[]--------[]--x-------------
]----[]---x---xx--[]-----------x-----xx<>-x---xxXXXXXXXX-------x----xx--[]--------[]---x------------
]----[]----xxxx---[]------E-----xxxxxx-[]--xxxxXXXXXXXXX--------xxxxx---[]--------[]-E-Exxxxxxxxxxxx
XXXXXXX--XXXXXXXXXXXX-----X---XXXXXXXXXXXXXXXXXXXXXXXXXXXXXXXXXXXXXXXXXXXXXXXXXXXXXXXXXXXXXXXXXXXXXX