----------------------------------------------------------------------------------------------------
----------------------------------------------------------------------------------------------------
---------------------------------------------------------------xxxx---------------------------------
-------------------------------------------------------xxxxx--xx---x--------------------------------
------------------------------------------------------xx----xxx-----xxxxxx--------------------------
X---------------------------QQQQQQQQQQS?QQQQ---------xxX-----x-------x----x-------------------------
]----------------------------------------[]---------xxXX----XX------XX-----x------xxx---------------
]----------------------------------------[]--------xxXXXXX------------------x----xx--x--------------
]----------------------------------------[]-------xxXXXX---------------------xxxxxX---x----------E--
>SSSSSS---------------Q---?QS-SSSSSSSSSS-<>------xxXXXXX----------------------xXEXX----x-----------x
------------------------------------------------xxXXXXXX----------------------XXXXX-----x---------xx
Exxx-------------------------E-----------xxx---xxXXXXXXX---------------------XXXXXX------x-------xx-
xxE-xxxxxxxxxxxxxxxxxxxxxxxxxxxxxxxxxxxxxxE-xxxxXXXXXXXX<>------------------XXXXXXX------Xxxxxxxxx--
X<>XXXXXXXXXXXXXXXXXXXXXXXXXXXXXXXXXXXXXX<>-XXXXXXXXXXXX[]------------------XXXXXXXXXXXXXXXXXXXXXXXX