----------------------------------------------------------------------------------------------------
----------------------------------------------------------------------------------------------------
-----------------------------------------------------------------------------------XXX-------XSSSSSS
--------------------------------------------------------------xxx------------------[]---------------
-----------------------------------------------------xxxxxxxxxx--x--------------E--[]---------------
xx--------------------------------------------------xx---x--XXX---x-----E-SSSSS---------------------
X-x------------------------------------------------xx-E--E--XXX----x-E------------------------------
X--x---------------------------------------------xxx--------XXX-----x-------------------------------
X---x-------------------------------------------xx-E--------XXX------x--------------------ooo-------
X----x--------xx----------------x--------------xx-----------XXX-------x----SSS---------------xxxx---
X-----x------xB-x-----------------------------xx------------XXX--------x--------------------xx---x-x
X------x----xxb--x--------------------xxxxxx-xx-------------XXX---------x------------------xx-----xx
E-------xxxxx-BEE-xxxxxxxxxxxxxxxxxxxxx--EE-xxX-------------XXX----------xxxxxxxxxxxxxxxxxxx------XX
XXXXXXXXXXXXXXXXXXXXXXXXXXXXXXXXXXXXXXX--XXXXXX-------------XXX----------XXXXXXXXXXXXXXXXXXX------XX