----------------------------------------------------------------------------------------------------
xxxxxxxxxxxxxxxxxxxxxxxxxxxxxxxx---------------------------------------------------------xx--------x
SSSSSSSSSSSSSSSSSSSSSSSSSSSSSSS-x-------------------------------------------------------xx-x------xx
SSS------------------------------x-----------------------------------------------------xx---x----xx-
SSS-------------------------------x-------------------xxxxx---------------------------xx-----xxxxx--
SSS----E---------------------------x---------------E-xxXXX-x--------------------------xS-----SSSSS--
------<>----------------------------x---------------xxXXXX--x-------------------------x-------------
------[]------------E----------------x-------------xxXXXXX---x--------------------xxxxx-------------
-E----[]-----------<>---------------E-x----------xxxXXXXXX----x-----------------xxx---x-------------
<>---?SSS--E-------[]--------------<>--x--------xx<>XXXXXX-----x--------SSS----xx<>---SS---------ES-
[]--------<>-------[]--<>-----E----[]---x------xx-[]XXXXXX------x-------------xx-[]--------E----<>--
[]--------[]---<>--[]--[]----<>----[]----x----xx-X[]XXXXXX-------xxx---------xx--[]-------<>----[]--
[]--------[]---[]--[]--[]----[]----[]-----xxxxx-XX[]XXXXXX-------XX-xxxxxxxxxx---[]-------[]----[]--
XXXXX----XXX---XX--XX--XX--XXXXXXXXXXXXXXXXXXXXXXXXXXXXXXXXXXXXXXXXXXXXXXXXXXXXXXXXXXXXXXXXXXXXXXXXX