----------------------------------------------------------------------------------------------------
---------------------------------------xxxx---------------------------------------------------------
--------------------------------------xx---x--------------------------------------------------------
-------------------------------------xx-----x-------------------------------------------------------
-------------------------------------xx------xxx----------------------------------------------------
-------------------------?-----------Sx----XXSS-x----------E-------------------------------------SSS
-----------------------------------xxxx----------x--------<>----------------------------------------
-------------------------xxxxx----xx--x-----------x-------[]-------------------------E--------------
----------------------xxxx----x--xx---S------------x------[]---xxxx----S------------<>------------E-
o-------------------xxx--S-----xxx------------------x-----[]--xx<>-x----------------[]-----------SSS
-------------------xx<>---------x--------------------x-------xx-[]--x---------------------?QQ-------
----------------B-xx-[]---X----<>---------------------x----Exx--[]---x-----xxx---------B------------
xxxxxxxxxxxxxxxxxxx--[]E--X----[]---E----------------X-xxxxxx---[]----xxxxxx--xxxxxxxxxxxxxxxxxxxxxx
XXXXEEXXEXXXXXXXXXXXXXXXXXXX---XXXXXXXXX-----------XXXXXXXXXXXXXXXXXXXXXXXXX--XXXXXXXXXXXXXXXXXXXXXX