----------------------------------------------------------------------------------------------------
----------------------------------------------------------------------------------------------------
SSSSSSSSSSSSSSSSSSSSSSSSSSSSSSSSSSSSSSSSSSSSSSSSSSSSSSSSSSSSSSSSSSSSSSSSSSSSSSSSSSSSSSSSSSSSSSSSSSSS
SSSSSSSSS-------[]---------------------------------------SSSSSSSSSSSSSSSSSSSSSSSSSS-----------------
SSSSSSSSS-------[]--------E------------------------------SSSSSSSSSSSSSSSSSSSSSSSSSS-----------------
SSSSSSSSS-------[]---QQQQQQQ-----------------------------SSSSSSSSSSSSSSSSSSSSSSSSSS-----------------
----------------[]-----------------xxxxxxx-------------------------------------------------------x--
xxx-------------[]----------------xx-SSSS-x---------------------------xxxxx------xxxxxxxx-----------
---xxxxxxx------[]--xxxxxxxxxxxxxxx--SSSS--xxxxxxxxxxxxxxxxxxxxxxxxxxxx----xxxxxxxE--<>--x--------xx
---SSSSSS-x-----[]-xxSSSSSSSSSSSSSS--SSSS?SS?SSSSS???????SSSSSSSSSSSSS?----SSSSSSSS--[]---x-------SS
-----------x----<>xx-SSSSSSSSSSSSSS---------SSSSSSSSSSSSS----------------------------[]----x------SS
<>----------x----xx--SSSSSSSSSSSSSS---------SSSSSSSSSSSSS---------------<>-----------[]-----x-----SS
[]-----------xxxxx---SSSSSSSSSSSSSS-------------------------------------[]-----------[]-----XxxxxxSS
XXXXXXXXXXXEXXXXXXE--XXXXXXXXXXXXXXXXXXXXXXXXX-XX-XXXXXXXXXXXXXXXXXXXXXXXXXXXXXXXXXXXXXXXXXXXXXXXXXX