----------------------------------------------------------------------------------------------------
----------------------------------------------------------------------------------------------------
------------------------------------------------------------------------------?---------------------
----------------------------------------------------------------------------------------------------
----------------------------------------------------------------------------------------------------
------QQQQQ--------------------------------------------------SSSSS--------------SS------------------
--------------------------------------------------------------------------------x---xxxx------------
----------------E------------------------------------------------------------------xxXX-x-----------
---------------<>--------------------xxxxx--------------------E-------------SS----xxXXX--x-----xx---
xxxx-?SQQSQ----[]------------------xxx----x------------------SSSSS-xxx-----------xxXXXX---x---xx-x-x
-<>-x----------[]----xxxx---------xx<>-----xx---------xxxx--------xxX-x--B-------xXXXXX----x-xx---xx
x[]--x---------[]---xx<>-x---B---xx-[]----<>-x---B---xx<>-x------xx-X--x-b----xxxXXXXXX-----xx----<>
--]---xxxxxxxxxxxxxxx-[]--xxxxxxxx--[]-E--[]--xxxxxxxx-[]--xxxxxxx--X---xxxxxxx-XXXXXXX-----<>----[]
XXXXXXXXXXXXXXXXXXXXXXXXXXXXXXXXXXXXXXXXXXXXXXXXXXXXXXXXXXXXXXXXXXXXXXXXXXXXXXX-XXXXXX------[]----[]