----------------------------------------------------------------------------------------------------
----------------------------------------------------------------------------------------------------
-----------------------------------------------------------------------------S----------------------
----------------------------------------------------------------------------------------------------
----------------------------------------------------------------------------------------------------
---------------------------------------------------------------------------XXXX---------------------
-------------xx------------------------------------------------------------XXX------------------E---
------------xx-x------------------------------------------------------------------------------------
-----------xx---x---------------------------------xxxx-xxxxxx-Exxxxx--xxx---------------------------
QQQQQQQxxxxx-----xxx--------------------------xxxxx---x-x----xxx----xxx--x--------------------------
------xx--<>-----<>-x--E---------XXXX-E------xx-XXX---XXX----XXX----XXX---x--------------E----------
x----xx---[]-----[]--x----------------------xx--XX----XX-----XX-----XX-----xx----------------------x
-xxxxxX---[]-----[]---xxxxxxxxxxxxxxxxxxxxxxxX----------------------------XX-xxxxxxxxxxxxxxxxxxxxxxx
XXXXXXX---XXXXX--XXXXXXXXXXXXXXXXXXXXXXXXXXXXX----------------------------XXXXXXXXXXXXXXXXXXXXXXXXXX