----------------------------------------------------------------------------------------------------
----------------------------------------------------------------------------------------------------
----------------------------------------------------------------------------------------------------
----------------------------------------------------------------------------------------------------
--------------------------------------------------------------------------xxxxxx--------------------
--------------------------SSSSSS---------------xxxxx---------------------xx?SSS-x-------------------
------------------------E---------------------xx-<>-x--------------------x-------x------------------
-------------------------xxxxx---------------xx--[]--x--------------xxxxxx-------Ex-----------------
xxx--------------------xxx----xx-----------xxx---[]---x------------xx---xE------<>-x----------------
XX-x------------------xx<>---<>-x---------xx<>--QQQ?---x----------xx----<>---E--[]--x---------------
XX--x----------------xx-[]---[]--x-------xx-[]----------x-------xxx-----[]--<>--[]---x--------------
XX---x--------------xx--[]---[]---x-----xx--[]-----------x-----xx<>-----[]--[]--[]----x-xxxxx-------
X-----xxxxxxxxxxxxxxx---[]---[]----xxxxxx---[]------E-----xxxxxx-[]--E--[]--[]--[]-----xx----xxxxxxx
X-----XXEXXXXXXXXXXXXXXXXX---XX--XXXXXXXXXXXXXX-----X---XXXXXXXXXXXXXXXXXXXXXXXXXXXXXXXXX---XXXXXXXX