----------------------------------------------------------------------------------------------------
-----------------------------------------------xxxxxxxxxxxxxxxxxxxxxxxxxxxxxxxxxxxxxxxxxxxxxxxxxxxxx
[-S[]SSSSSSSSSSSSSSSSSSSSSSSSSSS?SSSSS--------xxSSSSSSSSSSSSSSSSSSSSSSSSSSSSSSSSSSSSSSSSSSSSSSSSSSSS
[--<]-----------------SSSSSS-----------------xx-----------------------------------------------------
[xx[]-----------------SSSSSS------------XXX-xx------------------------------------------------------
<QQQQ-----------------SSSSSS--QQ-------xxxx-xSSS------------E------------------------------E--------
[-------------------------------------xx---xx--------------<>-----------------------------<>--------
---------------------------xxx-------xx-----xS-------------[]-----------------------------[]--------
?xxxxxxxxxxxxxxxxxxxxxxxxxxx--xxxxxxxx------S--------------[]-------S---------------------[]------S-
?SSSSSSSSS??????????-SSSSSSS--QQQSSSQS--------SS------E--SS[]SS---E----E-------E-----E--SS[]S---E---
SSSSSSSSSSSSSSSSSSSS?SSSSSSS-------------------------<>----[]----<>---<>------<>----<>----[]---<>---
SSSSSSSSSSSSSSSSSSSSSSSSSSSS-------------------------[]----[]----[]---[]------[]-----]----[]---[]---
SSSSSSSSSSSSSSSSSSSSSSSSSSSS-------------------------[]-E--[]----[]---[]------[]----x]-E--[]---[]---
XXXXXXXXXXXXXXXXXXXXXXXXXXXXXXXXX---XX------XXXXXXXXXXXXXXXXXXXXXXXXXXXXXXXXXXXXXXXXXXXXXXXXXXXXXXXX