----------------------------------------------------------------------------------------------------
----------------------------------------------------------------------------------------------------
---------------SSSSSSSSSSSSSSSSSSSSSSSSSSSSSSSSS--xx------------------------------------------------
---------------[]----[]--------------------------xx-x------xxx----xxx-------------------------------
---------------[]----[]-------E-----------------xx---x-xxxxx--xxxxx--x------------------------------
xxx------------<]----[]---QQQQQQ--------xxxxxxxxx-----xx--XX--XXXXX---x----------SSSSSSSSSSSSSS---QQ
XX-x-----------[]----[]----------------xxSSSSSSSS-----XX---------------x----------------------------
XX--x----------[]----[]---------------xx-SSSSSSSS-----------------------x-------------xxxxxxx-----<>
XX---x---------------[]--xxxxxxxxxxxxxx--SSSSSSSS------------------------x---------xxxxSSSSS-x----[]
XX----x-----S?S------[]-xxSSSSSSSSSSSSS--SSSSSSSS-------------------------x------xxxSSS-------x--QQQ
XX-----x-------------<>xx-SSSSSSSSSSSSS-----SSSSSS-------------------------x----xx<>-----------x----
XX------x-------xx----xx--SSSSSSSSSSSSS-----SSSSSS--------------------------xx-xx-[]------------x-xx
XX------Xxxxxxxxx-xxxxx---SSSSSSSSSSSSS------------------------------------XX-xx--[]-----E---EE--xx-
XXXXXXXXXXXXXXXXX-XXXXXE--XXXXXXXXXXXXXXXXXXXX-XXX------------XXXXXXXX-----XXXXXXXXXXXXXXXXXXXXXXXX-