----------------------------------------------------------------------------------------------------
-------------------------------------------------------------------------xx---x---------------------
---XSSSSSSSSSS----------------------------------------------------------xx-x--x---------------------
---[-----------------------------X-------------------------------xx----xx---x-----------------------
---[------------------------xxxxxx------------------------xxx---xx-xxxxx-----xx-xxx-----------------
---[-----------------------xx-XXX-x----------------------xx--x-xx--SSSSS-----x---XXx----------------
--------------------------xx--XXX--x--------------------xx----xx-------------x------x-----xxxx------
-------------------------xx---XXX---x------------------xx-----<>S------------x-------x---xx---x-----
-----------------------xxx----XXX----x---------------xxx------[]S------------S--------x-xx-----xxx--
xxx-------xxxxx-------xx<>----XXX-----x------SSS----xx<>------XXX----------------------xx------<>-x-
x--xxx---xxSSS-x-----xx-[]----XXX------x-----------xx-[]-------------------------------<>------[]--x
---<>-xxxx-SSS--x---xx--[]----XXX-------xxx-------xx--[]---<>------<>-----<>-----------[]------[]-<>
---[]---x--SSS---xxxx---[]----XXX-------XX-xxxxxxxx---[]---[]------[]-----[]-----------[]------[]-[]
XXXXXXX-X--XXX--XXXXXXXXXXXXXXXXXXXXXXXXXXXXXXXXXXXXXXXXXXXXXXXXXXXXXXXX--XXXXXxXXXXXXXXXXXXXXXXXXXX