----------------------------------------------------------------------------------------------------
----------------------------------------------------------------------------------------------------
----------------------------------------------------------------------------------------------------
----------------------------------------------------------------------------------------------------
----------------------------------------------------------------------------------------------------
--QQQQQ---------------------xxxxS-------SSS-------------------SSQSSS?SSS--------SSS-----------------
---------------------------xx--xxx---------------------------------------------------------xxxx-----
--------------------------xx------x-xxx---------------------------------------------------xxXX-x----
-------------------------xx----E-EExx--xx--------------E------------------------SSS------xxXXX--x---
ES?QQQS-----------------xxX--------XX-XX-x------------<>------SSSSSSSSSSS---------------xxXXXX---x--
------------------E----xxXXX-------XX-XX--x--------------------------------------------xxXXXXX----x-
-----------------<>---xxXXXX-------XX-XXX--x----------------------------------xxxxx---xxXXXXXX-----x
xxxxxxxxxxxxxxxxxxxxxxxXXXX--------X--XXX--Exxxxxxxxxxxxxxxxxxxxxxxxxxxxxxxxxxx----xxxxXXXXXXX-----E
XXXXXXXXXXXXXXXXXXXXXXXXXXX--------X--XXXXXXXXXXXXXXXXXXXXXXXXXXXXXXXXXXXXXXXXX----XXXXXXXXXX--XXXXX