----------------------------------------------------------------------------------------------------
----------------------------------------------------------------------------------------------------
----------------------------------------------------------------------------------------------------
----------------------------------------------------------------------------------o-----------------
-S------------------------------E-------------------------------------------------------------------
QQ--------------------------SSSSSS----S------------------------------------------XX-----------------
---------------------------------------------------------------------------------XX-----------------
xx---------------xxx---------------------------------------------------------xxx-XX---------xxxxx---
----------------xx--x--------E--------------------------xxxxx---------------xxXx-XX-------xxx--S-x--
QQx--SSS-------xx----xxx---SSSSSSS---xxxx-------------xxx----x-------------xxXX--XX------xx<>-----x-
-------------xxx-----<>-x-----------xx<>-x-----------xx<>-----xx---------ExxXXX-xXX-----xx-[]------x
------------xxXXX----[]--x---------xx-[]--x-------B-xx-[]----<>-x---B----xxXXXX--x-----xx--[]------X
xxxxxxxxxxxxx---B----[]---xxxxxxxxxx--[]---xxxxxxxxxx--[]-E--[]--xxxxxxxxxXXXXX---xxxxxx---[]----E-X
XXXXXXXXXXXXXXXXX----XXXXXXXXXXXXXXXXXXXXXXXXXXXXXXXXXXXXXXXXXXXXXXXXXXXXXXXXXXXXXXXXXXXXXXXXXXXXXXX