--------------------------------------------------
--------------------------------------------------
--------------------------------------------------
--------------------------------------------------
--------------------------------------------------
--------------------------------------------------
--------------------------------------------------
------------------xxxxx---------------------------
---------------xxxx-<>-x--------------------------
xx-x----SS----xxQQ?-[]--x--------------------xxx--
SSS-x--------xx-----[]---x------------------xxX-x-
SSQ--x------xx------[]----x----xxxxx-xxx---xx-X--x
o-----xxxxxxx--X----[]-----xxxxx----xx--xxxx--X---
X-XXXXXXXXXXXXXXXXXXXXXXXXXXXXXX---XXX--XXXXXXX--X