----------------------------------------------------------------------------------------------------
----------------------------------------------------------------------------------------------------
----------------------------------------------------------------------------------------------------
-----------------------------------------------------------------------------------------------xxx--
-------------xxxxxxxxxxx-----------E-E------------------xxxxxx-------------------------xxxx---xx--x-
------------xx--QQQ?QQQ-x-------SSSSSSSS-SS-xxxx-----xxxxX-XX-x-----------------------xx---x-xx----x
-----------xx------------x--------------E--xx---x---xx--EX-X---x---------------------xx-----xx----X-
----------xx------E-------x---------------xx-----x-xx---XX-X----x-------------------xx------<>---XX-
o-------xxx-----SSSS-SS----x------------xxx-------xx----XX-X-----x----------------xxx-------[]--XXX-
x------xx<>--------------E--x----------xx<>-------<>----XX-X------x-------SSS----xx<>-------X--XXXX-
-x----xx-[]-------X-X----X---x---E----xx-[]-------[]----XX-X-------x------------xx-[]---------XXXXX-
--x--xx--[]-------X-X----X----x------xx--[]-------[]----XX-X--------xxx--------xx--[]--------XXXXXX-
---xxx---[]----E--X-X----X-----xxxxxxx---[]-------[]----XX-X--------XX-xxxxxxxxx---[]----E--XXXXXXX-
XXXXXXXXXXXXXXXXXXXXXXXXXXXXXXXXXXXXXXXXXXX-------XX-XXXXX-XXXXXXXXXXXXXXXXXXXXXXXXXXXXXXXXXXXXXXXXX