----------------------------------------------------------------------------------------------------
----------------------------------------------------------------------------------------------------
-----SSSSSSSSSSSS-?SSSSSSSSSSSSSSSSSSSSSSSSSSSS-SSSSSSSSSSSSSSSSSSSSSSSSSSSSSSSSSSSSSSSSSSSSSS------
----------------------------------------------------------------------------------------------------
--------------------------------------------------E---------------------------------------------XXX-
-------------Sooooo---------------------------QQQQQQ------------------------------------------------
-------------S-----------------------------------]--------------------------------------------------
-------------SSSSSS------------------------------]---------------xxx--------------------------------
xxxxxxxxxxxx-SSSSSS------------------------------]-------------xxx--x----------------------xxxxxxx--
xS???S?????-xS-----------------xx------------QQQQQQQQ---------xx<>---x------xxxx----------xxXXX-x-x-
S-SSSSSSSSS--x----------------xB-x---------------------------xx-[]----xxx--xxSS-x--------xxEXXX-X--x
S-SSSSSSSSS---x--------------xxb--x-----------xxx-----------xx--[]----<>-xxx-SS--x------xxXXXXX-----
S-SSSSSSSSS----xxxxxxxxxxxxxxx-BEE-xxxxxxxxxxxx--xxxxxxxxxxxx---[]--E-[]--x--SS---xxxxxxxXXXXXX-----
XXXXXXXXXXXXXXXXXXXXXXXXXXXXXXXXXXXXXXXXXXXXXXX--XXXXXXXXXXXXXXXXXXXXXXXXXX--XX--XXXXXXXXXXXXX------