----------------------------------------------------------------------------------------------------
----------------------------------------------------------------------------------------------------
----------------------------------------------------------------------------------------------------
----------------------------------------------------------------------------------------------------
----------------------------------------------------E-----------------------------------------------
--------------------------------------------------SSSSSSSSSQ------------------------------------xxxx
-----------------------------------------------------------------------------------------------xx--x
-------------------------------------------------E--------------------------------------------xx----
xx------------------------xxxx----S----------------------------------------------------------xx----E
B-x----------------------xx<>-x----------------S?S---------S----SS----E--S------------------xxX-----
---x--------------------xx-[]--x-------------------------------------<>-------B-------E----xxXXX----
----x------------------xx--[]---x-----xxx----------xxx------------------------b------<>---xxXXXX----
--E-Exxxxxxxxxxxxxxxxxxx-E-[]----xxxxxx--xxxxxxxxxxx--xxxxxxxxxxxxxxxxxxxxxxxxxxxxxxxxxxxxxXXXX-----
XXXXXXXXXXXXXXXXXXXXXXXXXXXXXXXXXXXXXXX--XXXXXXXXXXX--XXXXXXXXXXXXXXXXXXXXXXXXXXXXXXXXXXXXXXXXX-----