--------------------------------------------------
-----------------------------------xxx------------
----------------------------------xx--x-----------
---------------------------------xx----x----------
---------------------------------xS-----x---------
-----------------S----S--------xxx-------xxxxxxxxx
--ooooo-----------------------xx-S-----E-SSSSSSSSS
-xxxx------------------------xx-------------------
xx---x----------xxxx--------xx--------------------
<>----x--------xx<>-x------xx------------------E--
-]-----x------xx-[]--x----xxE-----------------<>--
-]------x----xx--[]---x--xx<>-----------------[]--
-]-------xxxxx---[]----xxx-[]-----X-----------[]--
XXXXXXXXXXXXXXXXXXXXXXXXXXXXXXXXXXX-----------[]--