----------------------------------------------------------------------------------------------------
----------------------------------------------------------------------------------------------------
SSSSSSSSSSSSSSSSSSSSSSSSSSSSSSSS?SSSSSSSSSSSSSSSSSSSSSSSSSSSSSSSSSSSSSSSSSSSSSSS--->----------------
SS-----SSSS------SSSS-------------------------------------------------------------[]----------------
SS-E---SSSS--E---SSSS-------------------------------------------------------------XXX---------------
--SSS---S----SS-----------ooooooo------------------------------------------------------------E-----S
--SSS---S----SS---------------------------------xx--------------------------------------------------
--SSS---S----SS-----------SSSSSSS--------------xx-x-xxx---------------------------------------------
-oSSS---So??-SS---E-------SSSSSSS-------------xx---xx--x---------------------xxxxx-----SSSSSS?S---xx
SS------SSS--SS--SSSS-----------------------xxx----<>---x------xxxx---------xxXXX-xxxx-----------xx<
S---------------EE-------------------------xx<>----[]----xxx--xxSS-x-------xxEXXX-XXX-x---------xx-[
S-------------------xxxxxx----------------xx-[]----[]----<>-xxx-SS--x-----xxXXXXX------x-------xx--[
xxxxxxxxxxxxxxxxxxxxx-----xxxxxxxxxxxxxxxxx--[]----[]--E-[]--x--SS---xxxxxxXXXXXX-------xxxxxxxx---[
XXXXXXXXXXXXXXXXXXXXX----XXXXXXXXXXXXXXXXXXXXXXXXXXXXXXXXXXXXX--XX--XXXXXXXXXXXX-------XXXXXXXXXXXXX