--------------------------------------------------------------------------------[--------xxxxx------
xxxxxxxxxxxxxxxxxxxxxxxxxxxxxxx-------------------------------------------------[xxxxxx-xx----x-----
SSSSSSSSSSSSSSSSSSSSSSSSSSSSSS-x---SSSSSSSSSSSSSSSS-------------SSS--[]SSSSSSSSSSSSSSSSSSS-----x----
SS------------------------------x--SSSS------------------------------[]SSSSSSSS-----------------xx--
SS-------------------------------x-SSSS------------------------------[]SSSSSSSS-----------------E-x-
SS----E---------------------------xSSSS-------------xx--xxxxx--------[]SSSSSSSS--------------------x
-----<>----------------------------x---------------xx-xxx----x-------[]SSSSSSS--------<-------------
-----[]------------E----------------x-------------xx--XXX-----x------[]SSSSSS---------[-------------
-----[]-----------<>----------------oxxx------xxxxx------------x------]SSSSS----------[-------------
E---?SSS--E-------[]---------------S?SS-x----xx-XXX-------------xxxxx-]SSSSS<E---------x------------
>--------<>-------[]--<>-----E-----SSS---x--xx-----------SSS-S--SSSSSSSSSSSS<>---->-----x-----------
]--------[]---<>--[]--[]----<>-----SS-----xxx------------SSS-S--SSSSSSSSSSSS[]----]------x----------
]--------[]---[]--[]--[]----[]-------E-EE--xX------------SSS-S--SSSSSSSSSSSS[]----]------X----------
XXXX----XXX---XX--XX--XX--XXXXXXXXXXX-XXXXXXX---------XXXSSS-S--XXXXXXXXXXXX[]---<]-----XX----------