----------------------------------------------------------------------------------------------------
----------------------------------------------------------------------------------------------------
----------------------------------------------------------------------------------------------------
---------------------------------------------------------------------------------------------xxx----
-----------------------------------------------------------------------------------xxxx----xxx--x---
-----------------E-S---SSSSSSSSS-------------SS---SS-------------SSS-----E--------xx---x--xxXS---x--
----------------<>------------------------------------------------------<>-------xx-----xxxEX-----x-
-------xxx------[]------------------------------------------------------[]------xx-------xXXX------x
-----xxx--x-----[]-----------xxxx----------SS--------------xxxxx--------[]----xxx--------XXXXS------
----xx<>---x---SXXS---------xx--xxx-xxx--x-------SSS---xxxxx-XX-xSSS----XXX--xx<>-------XXXXX-------
--xxx-[]----x------xxx-----xx------xx--xx-x-----------xxXX<>-XX--x----------xx-[]------XXXXXX-------
-xx---[]--<>-x----x<>-x---xx-------<>--<>--x-xxxxx---xxXXX[]-XXX--x--------xx--[]-----XXXXXXX-------
xx----[]--[]--xxxxx[]--xxxx--------[]--[]---xx----xxxxXXXX[]-XXX---xxxxxxxxx---[]----XXXXXXXX-------
XX-XXXXX--XXXXXXXXXXXXXXXXX------XXXXXXXXxXXXX-X-XXXXXXXX-XXXXXXXXXXXXXXXXXXXXXXXXXXXXXXXXXXXXXXXXXX