----------------------------------------------------------------------------------------------------
----------------------------------------------------------------------------------------------------
----------------------------------------------------------------------------------------------------
----------------------------------------------------------------------------------------------------
S---------------------------------------------------------------------------------------------------
SS----------------------------------------------------------xxx----------------------------------Q--
SS---------------------------------------------------------xxX-x------------------------------------
----------------------------------------------------------xxXX--x-----------------------------------
xx----------xxxx--------------------------xx-------------xxXXX---x----------------------------------
>-x--------xx<>-x------------------xxxx--xx-x-----------xxXXXX----x--------xxx-------------Q---S?SQS
]--x------xx-[]--x----QQQQQQ?-----xx---xxx---x---------xxXXXXX-----x------xxX-x---------------------
]---x----xx--[]---x--------------xx-----x-----xx------xxXXXXXX------x----xx-X--x--------------------
]----xxxxx---[]----xxxxxxxxxxxxxxxX-----X-----X-xxxxxxxXXXXXXX-------xxxxx--X---xxxxxxxxxxxxxxxxxxxx
X--XXXXXXXXXXXXXXXXXXXXXXXXXXXXXXXX-----X-----XXXXXXXXXXXXXXXXXXXXXXXXXXXXXXXXXXXXXXXXXXXXXXXXXXXXXX