----------------------------------------------------------------------------------------------------
----------------------------------------------------------------------------------------------------
SS--------------------------------------------------------------------------------------------------
[]---------------------------------------------------------------[]---------------------------------
[]--------------------------------------------------------------x[]---------------------------------
[]----------------------E--------------------------------------QQ[]------------EXX------------------
[]--------------SSSSSSSSSSSSSS----------------------ooo-----------------------EXXX------------------
[]--------------------------------------------------------X------------------EXXXX------------------
[]----xxx---------------E---------------------------------------E---------X--XXXXX------------------
<>---xx--x-----------SS<>---------------------------------------------------XXXXXX-------xx--------x
-x--xx----x------------[]---------------------E----------------------------XXXXXXX------<>-x------xx
---xx------------------[]-------------------------------------------------XXXXXXXX------[]--x----xx-
xxxx------Xxxxxxxxxxxxx[]----------E-------------------------------------XXXXXXXXX------[]---xxxxx--
XXXX------XXXXXXXXXXXXXXXXXXXXXXXXXXXXXXX-------------------------------XXXXXXXXXXXXXXXXXXXXXXXXXXEX