----------------------------------------------------------------------------------------------------
-----------------------------------------------------------xxx--------------------------------------
----------------------------------------------------------xx--x-------------------------------------
---------------------------------------------------------xx----xx-----------------------------------
--------------------------------------------------------xx-------xxxxxxxxxxxx-----------------------
------------------------SSSS---------------------xxxxxxxx------E--x---x---XX-x------------SSSS------
--E---------------------------------------------xx?QQQQQQ--------<>---E---[]--x------------[]-------
-<>--------------------------------------------xx----------------[]-------[]---x-----------[]-------
-[]----------------------E-----------SS-------xx-----------------[]-------[]----x----------[]-------
QQQQQQQ---E------------SSSSS-x-----------xxxxxx------------------XX-------[]-----xx--------[]-------
[]-------<>-----xxxx--------xxxx--B-----xx--QQ?---S-----------------------<>-----B-x-------<>-------
<>-------[-----xx<>-x------xx-X-x-b----xx----------------------------------------b--x------xxx------
xxxxxxxxxxxxxxxx-[]--xxxxxxx--X--xxxxxxx-----------------------------------E-----B---xxxxxxxE-xxxxxx
XXXXXXXXXXXXXXXXXXXXXXXXXXXXXXXXXXXXXXXX-----------EE--------------------XXXXXXXXXXXXXXXXXXXXXXXXEXX