----------------------------------------------------------------------------------------------------
----------------------------------------xxx-------xxx-----------------xxx---------------------------
---[-]---------------------------------xx--x-----xx--x---------------xx--xxx------------------------
---[----------------------------xx----xx----x---xx----x-------------xx---[]-x-----------------------
---[---------------------------xxSxxxxx------x-xx------x-----------xx----[]--x----------------------
---[-------SS----SS--------xx-xx--SSSSS-------xx--------x-----xxxx-x----------x---------SSS-----E---
--------------------------xx-xx---------------XX---------x---xx---xx-----------x---------------<>---
-------------------------xx--<>---------------------------x-xx-----x------------x--------------[]---
---------SS------------xxx---[]----------------------------xx------S-------------xxxxxx--------[]---
xx-xxx----------SSS---xx<>---XXX--------------------------XXX---------------------xXXX-xSSS----XXX-x
>-xx--xxx------------xx-[]--------------------------------------------------------XXXX--x---------xx
[-<>--<>-x-xxxxxx---xx--[]--------<>-----<------------oo------------X------------XXXXXX--x-------xx-
]-[]--[]--xx-----xxxx---[]--------[]-----[------------oo-----------XX------------XXXXXX---xxxxxxxx--
XXXXxXXXXXXX-X--XXXXXXXXXXXXXXXXXXXXXXXXXX------------XX-----------XX------------XXXXXXXXXXXXXXXXXXX