----------------------------------------------------------------------------------------------------
----------xxx---------------------------------------------------------------------------------------
---------xx--x-------------------------------------------E------------------------------------------
--------xx----xx------------------------------------------------------------------------------------
-------xx-----E-xxxxxx-----------------------------------------------------------------------------x
-----xxx---------x----x-------SSSSSS----------XXXXXXXXSSS?S-------S----S--------------------------xx
----xx-S--------<>-----x--------------------------[]----------------------------------------------x-
---xx-----------[]------xxxx-------xxx------------[]-----------------------------------------xxxxxx-
--xx------------[]-------xB-xxxxxxxx--x-----------[]-------------xxxx--------xxxx-----------xx---xE-
-xx-------X-----XX-------XXXXESSSSSS---x----------[]------------xx<>-x------xx<>-x---------xx----<>-
xx-S--------------------XXXXXX----------x---------<>-----------xx-[]--x----xx-[]--x------xxx-----[]-
x>-S-------------------XXXXXXX-----------x--------xxx---------xx--[]---x--xx--[]---x----xx<>-----[]-
<]-S----X-------------XXXXXXXX----------B-xxxxxxxxxE-xxxxxxxxxx---[]----xxxE--[]----xxxxx-[]--E--[]-
XXXXXXXXX-------------XXXXXXXXXXXXXXXEXXXXXXXXXXXXXX-XXXXXXXXXXXXXXXXXXXXXXXXXXXX---XXXXXXXXXXXXXXXX