----------------------------------------------------------------------------xxx--------xxx---------x
---------------------------------------------------------------------------xx--x------xx--x-------xx
--------------------------------------------------------------------------xx----x----xx----x-----xx-
-------------------------------------------------------------------------xx------x--xx------x---xx--
--------------------E--------------------------------------------------xxx--------xxx--------xxxx---
-----xx-----E-SSSSS---------------------------------------------------xxXX--------XXX--------XXXX---
----xx-x-E-----------------------------------------------------------xxXXX--------XXX--------XXXX---
---xx---x-----------------------------------------------------------xxXXXX--------XXX--------XXXX---
-xxx-----x---------------------------------------------------------xxXXXXX--------XXX--------XXXX---
xxXX------x----SSS------------------------------------------------xxXXXXXXS-------XXX--------XXXX---
xEXX-------x------------------>---E------------------------------xxXXXXXXX--------XXX--------XXXX---
XXXX--------x-----------------]------------xxxxxx---------------xxXXXXXXXX--------XXX--------XXXX---
XXXX---------xxxxxxxxxxxxxxxxxxxxxxxxxxxxxxxE-EE-xxxxxxxxxxxxxxxxXXXXXXXXX--------XXX--------XXXX---
XXXX---------XXXXXXXXXXXXXXXXXXXXXXXXXXXXXXXXXXXXXXXXXXXXXXXXXXXXXXXXXXXXXXX------XXX--------XXXX---