----------------------------------------------------------------------------------------------------
----------------------------------------------------------------------------------------------------
----------------------------------------------------------------------------------------------------
----------------------------------------------------------------------------------------------------
----------------------------------------------------------------------------------------------------
--------------------------------------------------------------------------------------XX------------
o-----------------------------------------------------E-------------------------------XX------------
-----------------------------------------------------<>---------------------------xxx-XX------------
------E-------------------------------------xxxxx----[]--------------------------xxXx-XX------------
-----<>-----SS-----xxx---------------------xxXSS-x---XX-------------------------xxXX--XX------------
-----[------------xxX-x-------------------xx-X----x--------xxxx----------E----ExxXXX-xXX------------
---------------B-xx-X--x-----------------xx--X-----x----B-xx<>-x---B----------xxXXXX--x--------xx---
xxxxxxxxxxxxxxxxxx--X---xxxxxxxxxxxxxxxxxxE-EX------xxxxxxx-[]--xxxxxxxxxxxxxxxXXXXX---xxxxxxxxxXxxx
XXXXXXXXXXXXXXXXXX--XXXXXXXXXXXXXXXXXXXXXXXXXXXXX---XXXXXXXXXXXXXXXXXXXXXXXXXXXXXXXXXXXXXXXXXXXXXXXX