----------------------------------------------------------------------------------------------------
-------------------------------------------------------xxx------------------------------------------
---------------------------E--------------------------xx--x-----------------------------------------
-----------------------------------------------------xx----xx---------------------------------------
----------------------------------------------------xx-----E-xxxxxx---------------------------------
------------------------SSS?S-------S----S--------xxx---------x----x--------------------------------
-------------E-----------------------------------xx-S--------<>-----x-------------------------------
------------<>----------------------------------xx-----------[]------xxxx----xxxxx------------------
--xxxxxx----[]---------------------xxxx--------xx------------[]-------xB-xxxxx--x-x-----------xxxx--
-xxXSSS-x---XX--------------------xx<>-x------xx-------X-----XX-------XXXXEXXX--S--x---------xx<>-x-
xx-X-----x--------xxxx-----------xx-[]--x----xxE---------------------XXXXXXXXX------x-------xx-[]--x
x--X------x----B-xx<>-x-------B-xx--[]---x--xx<>--------------------XXXXXXXXXX-------x-----xx--[]---
--EX-------xxxxxxx-[]--xxxxxxxxxx---[]----xxx-[]-----X-------------XXXXXXXXXXX--------xxxxxx---[]---
XXXXXXXX---XXXXXXXXXXXXXXXXXXXXXXXXXXXXXXXXXXXXXXXXXXX-------------XXXXXXXXXXXXXXXXXXEXXXXXXXXXXXXXX