----------------------------------------------------------------------------------------------------
----------------------------------------------------------------------------------------------------
----------------------------------------------------------------------------------------------------
----------------------------------------------------------------------------------------------------
--------------------------------------------------------------xxx-------xxxxxxxxxxx----------E-E----
SSSS-----------------------------------xxx-------------------xx--x-----xx--QQQ?QQQ-x-------SSSSSSS-S
--------------------------------------xx--x-----------------xx----x---xx------------x-------------E-
-------------------------------------xx----x---------------xx------x-xx------E-------x--------------
-E----------------------------------xx----E-x--------o---xxx--o-----xx-----SSSSSSS----x-----------xx
<>----------------E--S-------------xxX-------xx---------xx<>--------<>--------------E--x---------xx<
[]---------------<>----------E----xxXXX-----XX-x-------xx-[]--------[]-------X------X---x---E---xx-[
[]-----xxxx-----------------<>---xxXXXX-----XXX-x-----xx--[]--------[]-------X------X----x-----xx--[
xxxxxxxx---xxxxxxxxxxxxxxxxxxxxxxxXXXX------XXXX-xxxxxx---[]--------[]----E--X------X-----xxxxxx---[
XXXXXXXX---XXXXXXXXXXXXXXXXXXXXXXXXXXX------XXXXXXXXXXXXXXXXXXXXXXXXXXXXXXXXXXXXXXXXXXXXXXXXXXXXXXXX