----------------------------------------------------------------------------------------------------
-----------------------------------------xxxxxxxxxxxxxxxxxxxxxxxxxxxxxxxxxxxxxxxxxxxxxxxxxx---------
SSSSSSSSSSSSSSSSSSSSSSSSSSSSSSSS--------xxSSSSSSSSSSSSSSSSSSSSSSSSSSSSSSSSSSSSSSSSSSSSSSSS-x-----SSS
SSSSSSSSSSSSSSSSSSSSSS-----------------xx---------------------------------------------------x-------
SSSSSSSSSSSSSSSSSSSSSS------------XXX-xx-----------------------------------------------------x----?-
SSSSSSSSSSSSSSSSSSSSSS--QQQ------xxxx-xSSS-----------E----------------------------------------x--S??
-------------------------x------xx---xx-------------<>-----------------------------------------x----
---xxx---------------xxxXXxxx--xx-----xS------------[]------------------------------------------x--x
xxxx?-xxxxxxxxxxxxxxxx--xxx--xxx------S-S-----------[]------S-------------------------E----------xxx
SSSS??SSSSSSSSSSSSSSSS--QQS--QQQ---------S-----E--SS[]S---E---E----------------------<>------XXX-SSS
SSS---SSSSSSSSSSSSSSSS------------------------<>----[]---<>--<>--------E----------XX-[]--XXX--------
SSS---SSSSSSSSSSSSSSSS------------------------[]----[]---[]--[]-------<>---------XXX-[]--XXX--------
---oooSSSSSSSSSSSSSSSS------------------------[]-E--[]---[]--[]-------[]----E-E--XXX-[]--XXX--------
XXXXXXXXXXXXXXXXXXXXXXXXXXXXXXXX------XXXXXXXXXXXXXXXXXXXXXXXXXXXXXXXXXXXXXXXXXXXXX--XX--XX------XXX