----------------------------------------------------------------------------------------------------
----------------------xxxxxxxxxxxxxxxxxxxxxxxxxxxxxxxxxxxxxxxxxxxxxxxxxx----------------------------
SSSSSSSSSSSSS--------xxSSSSSSSSSSSSSSSSSSSSSSSSSSSSSSSSSSSSSSSSSSSSSSSS-x-----SSSSSSSSSSSSSSSSSSSSSS
SSS-----------------xx---------------------------------------------------x-----------SS---SSSS------
SSS------------XXX-xx-----------------------------------------------------x----------SS---SSSS--E---
SSS--QQQ------xxxx-xSSS-------------E--------------------------------------x---------SS----S----SS--
SS-----------xx---xx---------------<>---------------------------------------x--------SS----S----SS--
SSxxx--xxx--xx-----xS--------------[]----------------------------------------x-------SS----S----SS--
xxx--xxx--xxx------S-S-------------[]-------S----------------------E----------xxxxxx-SS----So??-SS--
><>--QQQ--QQQ---------S-------E--SS[]SS---E----E------------------<>------XXX-SSSS?-xSS----SSS--SS--
][]--------------------------<>----[]----<>---<>---------------XX-[]--XXX---------S--x-------------E
][]--------------------------[]----[]----[]---[]--------------XXX-[]--XXX---------S?--x-------------
][]-------------------------x[]-E--[]----[]---[]---------E--E-XXX-[]--XXX--------------xxxxxxxxxxxxx
XXXXXXXXXXXXX------XXXXXXXXXXXXXXXXXXXXXXXXXXXXXXXXXXXXXXXXXXXXX--XX--XX------XXXXXXXXXXXXXXXXXXXXXX