----------------------------------------------------------------------------------------------------
---------------------------------------------------------xxx----------------------------------------
--------------------------------------------------------xx--x---------------------------------------
-------------------------------------------------------xx----xx-------------------------------------
----------------xxxxx--------------------------xxx----xx-----E-xxxxxx-------------------------------
----xxxx-----xxxx--X-x------------------------xx--x--xx---------x----x-------SSSS-----------XXXXXXXX
-E-xx---x---xx--E--X--x----------------------xx-E--xxx---------<>-----x----------x--------------[]--
--xx-----x-xx---XX-X---x--------------------xx-----XXX---------[]------xxxx-------xx------------[]--
xxx-------xx----XX-X----x------------xxxxxxxx------------------[]-------xB-xxxxxxx--x-----------[]--
x<>-------<>----XX-X-----x----------xx-XXXXXX-------<----------XX-------XXXXESSSSS---x----------[]--
-[]-------[]----XX-X------x--------xx---------------o---XX-------------XXXXXX---X-----x---------<>--
-[]-------[]----XX-X-------S------xx----------------------------------XXXXXXX---X------x--------xxx-
-[]-------[]----XX-X-------xxxxxxxx----------------------------------XXXXXXXX---------B-xxxxxxxxxE-x
XXX-------XX-XXXXX-XXXXXXXXXXXXXXXX----------------------------------XXXXXXXXXXXXXXEXXXXXXXXXXXXXX-X