--------------------------------------------------
--------------------------------------------------
--------------------------------------------------
--------------------------------------------------
--------------------------------------------------
-----------------x-------------E---S---SSSSSSSSS--
------------------------------<>------------------
------------------------------[]------------------
----------------xxxxxx--------[]-------------xxxx-
-xxx---------xxxx--XX-x------SXXS-----------xx--xx
xx--xx------xx-<>--XX-Xxx---------xxxx-----xx-----
<>--<>-----xx--[]--XXXXX-x-------xx<>-x---xx------
b]--[]----xx---[]--XXXXX--xxxxxxxx-[]--xxxx-------
XXXXXXxxxxx----XXXXXXXXXXXXXXXXXXXXXXXXXXXX------X