--------------------------------------------------
--------------------------------------------------
--------------------------------------------------
---------xxxxx------------------------------------
-------xxx----x------------------xxxxx------------
------xx<>-----x--------------E-xxXXX-x-----------
-----xx-[]------x--------------xxXXXX--x----------
----xx--[]-------x------------xxXXXXX---x---------
--xxx--Q[]--------x--xxx---xxxxXXXXXX----x--------
-xx<>---[]---------xxxS-x-xxX<>XXXXXX-----x-------
xx-[]---[]----------x----xxXX[]XXXXXX------x------
x--[]---[]----------SS-SSxXXX[]XXXXXX-------xxx---
---[]---[]--------X-SS-SSXXXX[]XXXXXX-------XX-xxx
XXXXXXXXXXXXXXXXXXXXXXXX-XXXXXXXXXXXXXXXXXXXXXXXXX