--------------------------------------------------
----------xx--------xxx---------------------------
---------xx-x------xx--x--------------------------
--------xx---x----xx----x-------------------------
-------xx-----xxxxx------x------------------------
-------xS-----SSSSS-------x----------------SSSSSSS
-------x-------------------x-----xxxx-------------
---xxxxx--------------------x---xx---x-xxxx-------
-xxx---x---------------------x-xx-----xx---x--xxxx
xx<>---SS---------ES----------xx------<>----xxx?S<
x-[]-------------<>-----E-----<>------[]-----<>--[
--[]-------------[]----<>-----[]------[]-----[]--[
o-[]-------------[]----[]-----[]------[]-E---[]--[
XXXXXXXXXXXXXXXXXXXXXXXXXXXXXXXXXXXXXXXXXXXXXXXXXX