----------------------------------------------------------------------------------------------------
----------------------------------------------------------------------------------------------------
----------------------------------------------------------------------------------------------------
----------------------------------------------------------------------------------------------------
----------------------------------------------------------------------------------------------------
E-----------------------------xxx-------------------------------------------------S--xxxxx----------
>----------------------------xxX-x--------------------------------------------------xx-<>-x---------
]---------------------------xxXX--x--------------xxxxx-----------------------------xx--[]--x--------
]---xxx--------------------xxXXX---x----------xxxx-<>-x---Q--Q--?----------------xxx---[]---x-------
[S-xx--x------------------xxXXXX----x--------xxQQ?-[]--x--------------S---------xx<>--QQQ?---x------
--xx----x----------------xxXXXXX-----x------xx-----[]---x-----------E----------xx-[]----------x-----
-xx------x--------------xxXXXXXX------x----xx------[]----x------E-----xxxxx---xx--[]-----------x----
xx-------XxxxxxxxxxxxxxxxXXXXXXX-------xxxxx--X----[]-----xxxxxxxxxxxxx----xxxx---[]------E-----xxxx
XXX-----XXXXXXXXXXXXXXXXXXXXXXXXXXXXXXXXXXXXXXXXXXXXXXXXXXXXXXXXXXXXXXX----XXXXXXXXXX-----X---XXXXXX