--------------------------------------------------
--------------------------------------------------
--------------------------------------------------
--------------------------------------------------
Q-------------------------------------------------
--------------------------------------------------
--------------------------------------------------
--------------------------------------------------
xxxxxx---Q--Q?-------X---------------------------S
x--<>-x-----------ESSX--------------E---S-------SS
---[]--x---------------------------<>-------------
---[]---x----xxx-------------------------------xxx
E--[]----xxxxx--xxxxxxxxxxxxxxxxxxxxxxxxxxxxxxxxB-
XXXXXXXXXXXXXX--XXXXXXXXEEXEXXXXXXXXXXXXXXXXXXXXXX