----------------------------------------------------------------------------------------------------
---------------------------------------------------------------------xxxx---------------------------
-----------------------------------------E--------------------------xx---x--------------------------
-------------------------------------------------------------------xx-----x-------------------------
----------------xxxxxxxxxxx---------------------------------------xx-------x--------------------xxx-
---------------xx--QQQ?QQQ-x-------SSSSSS?S--------S----S--------xx---------x------------------xx--x
--------------xx------------x-----------------------------------xxX----------x----------------xx----
-------------xx------E-------x---------------------------------xxXX-----------x--------------xx-----
<----------xxx-----SSSSSSS----x-------------------xxxx--------xx-XX----------S-x-------o---xxx--o---
----------xx<>--------------E--x----E------------xx<>-x------xx-XXX-------E-----xxx-------xx<>------
--xx-----xx-[]-------X------X---x---------------xx-[]--x----xxE-XXX------<>-----<>-x-----xx-[]------
xx>-x---xx--[]-------X------X----x-------------xx--[]---x--xx<>-XXX------[]-----[]--x---xx--[]------
x-]--xxxx---[]----E--X------X-----xxxxxxxxxxxxxx---[]----xxx-[]-XXX------[]-E---[]---xxxx---[]------
XXXXXXXXXXXXXXXXXXXXXXXXXXXXXXXXXXXXXXXXXXXXXXXXXXXXXXXXXXXXXXXXXXXXXXXXXXXXXXXXXXXXXXXXXXXXXXXXXXXX