--------------------------------------------------
-----------------------------------------------xx-
--------------------S-------------------------xx-x
--------XXXXXXXXXX--S------------------------xx---
-------XX-----------S------------------xxxxxxx----
<-----XXX-----------S---------------xxxx---XXX----
]----XXXX-----------S--------------xxXXX----------
]---XXXXX-----------S-------------xx--------------
]--XXXXXX-----------S---------xxxxx---------------
>-XXXXXXX-----------S--------xx-XXX--------XXX----
]XXXXXXXX----<>-----S-------xx--------------------
XXXXXXXXX----[]-----S------xx---------------------
XXXXXXXXX----[]-----Sxxxxxxx----------------------
XXXXXXXXXXXXXXXXXXXXXxXXXXXX----------------------