----------------------------------------------------------------------------------------------------
---------------X------------------------------------------------------------------------------------
----------------XXX---------------------------------------------XXXX--------------------------------
----------------[]---------xxxxx---------------------------------[]---------------------------------
----------------[]-------xxx----x--------------------------------[]---------------------ooooooooo--E
----------------<>------xx<>-----x-------------------------------<>-------------------SSSSSSSSSSSSSS
-----------------------xxX[]------x-----------------------------------------------------------------
-----------------E-----xXX[]-------x-----------xxx----------------E---xx----------------------------
---------------------xxxXX[]--------x--xxx---xxx--x-----------------xxx--------------xxxxxxxxxxxxxxx
xxx------------xxxx-xx<>XX[]---------xxxS-x-xxXX---x------------xx-xxXX-x-----------xx--?SSSSSSSSSSS
xX-x----------xx---xxX[]XX[]----------x----xxXXX----xxx--------xx-xXXXX--x---------xx---------------
-X--x-------Exx---<>XX[]XX[]----------SS-SSxXXXX----XX-x------xx---XXXX---x-------xx----------------
-X---xxxxxxxxx----[]XX[]XX[]--------X-SS-SSXXXXX----X---xxxxxxx----XXXX---oxxxxxxxx------------E----
XXXXXXXXXXXXXX----[]XXXXXXXXXXXXXXXXXXXXXX-XXXXX----X---XXXXXXX----XXXXXXXXXXXXXXXX---XXXXXXXXXXXXXX