-----------------xxxxxxxx----------------------------------------xxxxx-----x------------------------
--------xxxxxxxxxx--X-xX-xxxxxxxxxxxxxxxxxxxxxxxxxxxxxxxxxx-x-xxxx----x------xxx-----------------xx-
SSSSSSSSSSSSSSSSS--------SSSSSSSSSSSSSSSSS?SSSSSSSSSSSSSSSS-S-SSSS-----x----xx--x------xxx------xx-x
-------------------------SSSSSSSSSSSSSSSS----XX-------------------------x--xx----x----xx--x----xx---
-------------------------SSSSSSSSSSSSSSSS--------------------------------xxx---------xx----xxxxx----
-------------------------SSSSSSSSSSSSSSSS------------------XXX------------x-------X-xx-----XXXXX----
---------------------X---S-----------------------------------------------XX--------xx---------------
-------------------------S--------------------------------------------------------xx----------------
-------------E------------?oooooooooo---------------------------------------------XX----------------
------------<>------------??SSSSSSSSS----XX---------------------------------------------------------
xx-------XX-[]--XXX---------------------XXX--------XXX----------------------------------------------
>-x---E-XXX-[]--XXXXXX-----------------XXXX--XXX------------------XXXX-----------o--------------o---
]--xxxxxxxx-[]--XXX--------------EE---XXXXX--------------------------------------o---------oooooo---
X--XXEXXXX--XX--XX----XX-XXXXXXXXXXXXXXXXXXX-------------------------------------X---------XXXXXX---