----------------------------------------------------------------------------------------------------
----------------------------------------------------------------------------------------------------
----------------------------------------------------------------------------------------------------
----------------------------------------------------------------------------------------------------
------------------------------------xxxxx--------------------xxxxx----------------------------------
-------E-------------------------E-xxXXX-x----------------xxxxSx--x---------------------------------
------<>--------------------------xxXXXX--x----------x---xx--E<>---x--------------------------------
------[]----xxxx----xxxx---------xxXXXXX---x----------x-xx---X[]----x-------------------------------
------[]--xxx---x-xxx----------xxxXXXXXX----x----------xx----X[]-----x-----------E--------------xxxx
x----SXX-xx<>----xx<>---------xx<>XXXXXX-----x---------<>--Q?X[]------x---------<>-----ooo-----xxXX-
-xx-----xx-[]---E<>[]--------xx-[]XXXXXX------x--------[]----X[]-------x----------------------xxXXX-
<>-x---xx--[]--<>[][]---x---xx-X[]XXXXXX-------xxx-----[]----X[]--------x--------------------xxXXXX-
[]--xxxx---[]--[][][]----xxxx-XX[]XXXXXX-------XX-xxxx-[]----X[]-------X-xxxxxxxxxxxxxxxxxxxxxXXXXX-
XXX-XXXXXXXXXXXXXXXXXXXXXXXXXXXXXXXXXXXXXXXXXXXXXXXXXXXXXXXXXXXXXXXX-XXXXXXXXXXXXXXXXXXXXXXXXXXXXXXX