----------------------------------------------------------------------------------------------------
----------------------------------------------------------------------------------------------------
-----------------------------------------------------------------------------?----------------------
----------------------------------------------------------------------------------------------------
--------------------------------xxxx---------------------------------------------xxx-xxxxx----------
S---------------Q-?-Q----------xx---xSSS------------------------------------S---xx--xSSSSS------xx--
------------------------------xx-----x--xxxxxxxxxx-----------------------------xx----x---------xx-x-
----------------------E---E--xx-------xxxXXXXXXXX-x----------------x----------xx------x-------xx---x
---------------xxx----xxxxxxxx---------xXXXXXXXX---x----xx-----------xxxxxxxxxx--------x------x-----
-xxxxxxxxxxxxxxxE-xxxxxXXXXXXX---------XXXX---------x--xx-x-xxxxx---xx-XXXXXXXX---------x-----Q---?S
xxXXXXXXXXXXXXXXEXXXXXXX--------------XXXXX----------xxx---xx----x-xx--------------------x----------
xXXXX--------------------------------XXXXXX-----------x----<>-----xx----------------------x---------
XXXXX-------------------------------XXXXXX----<>-----<>----[]-----<>-----------------ooooo-xxxx-----
XXXX--------------------------------XXXXXX----[]-----[]----[]-----[]-----------------XXXXXXXXXXXXXXX