----------------------------------------------------------------------------------------------------
----------------------------------------------------------------------------------------------------
--------------------------------------------------------------------------------o-------------------
--------------------------------------------------------------------------------------------xxx-----
---------------------------------------------xxxx----------------------------------------xxxx--x----
--------------------------------------------xxXX-x------------------------------XXXX----xx-XXE--x---
-------------------------------------------xxXXX--x------------------------------------xx--------x--
-X----------------------------------------xxXXXX---x----------------------------------xx----------x-
--------------E--------------------------xxXXXXX----x----------------------------xxxxxx------------x
-------------<>-------------------------xxXXXXXX-----x------------------XXXX----xxXXXXX-------------
xx-----------[-------------------------xxEXXXXXX------x------------------------xx-------------------
--x------x----E-----xxxxx--------E----xxXXXXXXXX-------x--x------xxx----xxx---xx--------------------
x--xxxxxxxxxxxxxxxxxx----xxxxxxxxxxxxxxXXXXXXXXX-------Xxx-xxxxxxx--xxxxx--xxxx---------------XXXXEX
X--XXXXXXXxXXXXXXXXXX---XXXXXXXXX>XXXXXXXXXXXXXXXXXXXXXXXXXXXXXXXX--XXXXX--XXXX---------XXXX--------