----------------------------------------------------------------------------------------------------
----------------------------------------------------------------------------------------------------
----------------------------------------------------------------------------------------------------
----------------------------------------------------------------------------------------------------
----------------------------------------------------------------------------------------------------
--------------------------------------------SSSSSSS---------------E-----E---------------------------
---------------------------------------------------------------E------------------------------------
-----------------------------------------------------------xxxxxxxxxxxxxx---------------------------
---------------------------------------------E--E---------xxXSSSSSSSSSSS-x-----xx-----------xxxxxxxx
---X----------------------------------------SSSSSSS------xxXX-------------x---xx-x-xxxxx---xx-XXXXEX
EE-X-------------------------------Q?QQQ----------------xxXXX----ooooo-----x-xx---xx----x-xx--------
SSSX---------------xxx-------------------------xxx-----xxXXXX---------------xx----<>-----xx---------
xxxxxxxxxxxxxxxxxxxxE-xxxxxxxxxxxxxxxxxxxxxxxxxx--xxxxxxXXXXX----ooooo------<>----[]-----<>---------
XXXXXXXXXXXXXXXXXXXXXXXXXXXXXXXXXXXXXXXXXXXXXXXX--XXXXXXXXXXXXXXXXXXXXXX----[]----[]-----[]---------