--------------------------------------------------
--------------------------------------------------
--------------------------------------------------
--------------------------------------------------
--------------------------------------------------
-----SSSSSSSSS------------SS----SS-------------SSS
--------------------------------------------------
--------------------------------------------------
x----------xxxx---------SS---------------xxxxx----
-x--------xx--xxx-xxx----------SSS---xxxxx-XX-xSSS
--xx-----xx------xx--xxx------------xxXX<>-XX--x--
-<>-x---xx-------<>--<>-x-xxxxxx---xxXXX[]-XXX--x-
-[]--xxxx--------[]--[]--xx-----xxxxXXXX[]-XXX---x
XXXXXXXXX------XXXXXXXXXXXX-X--XXXXXXXX-XXXXXXXXXX