-------------------------------------------------xxxxx----------------------------------------------
----------------------------xxxxxxxxxxxxxxxxxxxxxx----xxxxxxxxxxxxxxxxxxxxxxxxxxxxxxxxx-------------
SSSSSSSSSSSSSSSSS?SSSSSSSSSSSSSSSSSSSSSSSSSSSSSSSS----SSSSSSSSSSSSSSSSSSSSSSSSSSSSSSSS-x---SSSSSSSSS
------------------------------------------------------SSSS------------------------------x--SSSS-----
------------------------------------------------------SSSS-------------------------------x-SSSS-----
-E-------------ooo-o-oo-------------------------------SSSS----E---------------------------xSSSS-----
<>-----------------------------------------------------------<>----------------------------x--------
[]-----------S-SSS-S-SS--------------------------------------[]------------E----------------x-------
S]--xxxx-----SoS---SoS----------------------------------E----[]-----------<>----------------oxxx----
---xx<>-x----SSS---SSS-------E-------------XXX---------<>---?SSS--E-------[]---------------S?SS-x---
--xx-[]--x------------------<>-----S-------------------[]--------<>-------[]--<>-----------SSS---x--
-xx--[]---x-----------------[]-----S-------------------[]--------[]---<>--[]--[]----<>-----SS-----xx
xx---[]----xxxxxxxxxxxxxx---[]-----S-------------------[]--------[]---[]--[]--[]----[]-------E-EE--x
XXXXXXXXXEXXXXXXXXXXXXXXX---[]-----S--------------XXXXXXXXXX----XXX---XX--XX--XX--XXXXXXXXXXX-XXXXXX