----------------------------------------------------------------------------------------------------
----------------------------------------------------------------------------------------------------
-------------------------------------------------------------E--------------------------------------
----------------------------------------------------------------------------------------------------
----------------------------------------------------------------------------------------------------
--xx-------------------------------------------------SSSSSSSS?S--------S-----E-------------xx-------
-xx-x-------------------ES--------------E-------------[]-----------------------------E----xx-x------
xx---x------------------------QQQ------<>-------------[]---------------------------xxxx-xxxX--x-----
x-----x--------------------------------[]-------------[]--------------xxxx--------xx---x-xXX---x----
>------x----------------------------QQQQQQQQQQ--------[]-------------xx<>-x-------x-----XXXX----x---
]-------x---------xxx---------------------------------<>------------xx-[]--x------------XXXX-----x--
]--------x-------xxB-x----------xxxxx-----------------xxx----------xx--[]-S-x-----------XXXX------xx
>-------XXxxxxxxxx-b--xxxxxxxxxxxB---xxxxxxxxxxxxxxxxxxE-xxxxxxxxxxx---[]----xxxxxx-----XXXX------XX
X-------XXXXXXXXXXXXXXXXXXXXXXXXXX--XXXXXEEXXXXXXXXXXXXXXXXXXXXXXXXXXXXXXXXXXXXXXXXXXXXXXXXXXXXXXXXX