--------------------------------------------------
--------------------------------------------------
--------------------------------------------------
--------------------------------------------------
--------------------------------------------------
-------E--S---SSSSSSSSS------------SS---SS--------
------<>------------------------------------------
------[]------------------------------------------
------[]------------xxxx---------SS--------------x
x----SXXS----------xx--xxx-xxx---------SSS---xxxxx
-xx------xxxx-----xx------xx--xxx-----------xxXX<>
<>-x----xx<>-x---xx-------<>--<>-x-xxxxx---xxXXX[]
[]--xxxxx-[]--xxxx--------[]--[]--xx----xxxxXXXX[]
XXXXXXXXXXXXXXXXXX------XXXXXXXXXXXX-X-XXXXXXXX-XX