----------------------------------------------------------------------------------------------------
----------------------------------------------------------------------------------------------------
----------------------------------------------------------------------------------------------------
----------------------------------------------------------------------------------------------------
----------------------------------------------------------------------------------------------------
X------------------------------------------------XX------------------------QQ?QQQQQQ--------?-------
]------------------------------------------------[]------------------------------------------------x
]------------------------------------------------[]-----------------------------------------------xx
]-------------------------------------xxxx-------[]----------------------------------------------xx-
>SSSSSS------------------------------xx---xx-----<>SSSSSS--------------------SSSSSSSSS---------xxx--
-----------------------Q?QQQQ?QQ----xx----X-x---------------------------------------------E---xx<>--
Exxx-------------------------------xx-----XX-xx---Exxx----------------------E--E-------------xx-[]--
xxE-xxxxxxxxxxxxxxxxxxxxxxxxxxxxxxxxX-----XXXX-xxxxxE-xxxxxxxxxxxxxxxxxxxxxxxxxxxxxxxxxxxxxxxx--[]E-
X<>XXXXXXXXXXXXXXXXXXXXXXXXXXXEXXXXXX-----XXXXXXXXX<>-XXXXXXXXXXXXXXXXXXXXXXXXXXXXXXXXXXXXXXXXXXXXXX