----------------------------------------------------------------------------------------------------
----------------------------------------------------------------------------------------------------
SSSSSSSSSSSSSSSSSSSSSSS-----------------------------------------------------------------------------
----------------------------------------------------------------------------------------------------
-------------------------XXX------------------------------------------------------------------------
----------------------------------------XXX---------------------------------------------------------
----------------------------------------------------------------------------------------------------
-----------------------------------------------------------xxxxx------------------------------------
--------------------xxxxx-----SSSSS??--------------------xxx----x-xxx----xx-------------------------
------xxxx---------xxXXX-xxxx---------------------------xxXX-----xx--x--xx-x-------------------E----
xx---xxSS-x-------xxEXXX-XXX-x-------------------------xx-------XXX---xxx---x------------E----<>---X
>-x-xx-SS--x-----xxXXXXX------x------xxx---------xxxxxxx---------------x-----xx--------x<>----[]--XX
]--xx--SS---xxxxxxXXXXXX-------xxxxxxx--xxxxxxxxxx--XXXX---------------X-----X-xxxxxxxxx[]----[]-XXX
XXSXX--XX--XXXXXXXXXXXX-------XXXXXXXX--XXXXXXXXXX---------------------X-----XXXXXXXXXXXXXXXXXXXXXXX