--------------------------------------------------
--------------------------------------------------
SSSSSS----------SSSSSSSSSSSSSSSSSSSSSSSSSSSSSSSSSS
----------------------------------SSSSSSSSSSSSSSSS
--------------------xxx-----------SSSSSSSSSSSSSSSS
-------------xxxxxxxx--x----------SSSSSSSSSSSSSSSS
x-----------xxSSSSSSS---xxxxx---------------------
-x---------xx-SSSSSSS--SSSSS-x--------------------
E-x-----xxxx--SSSSSSS--SSSSS--xxxxxxxxxxxxxxxxxxxx
>--xxxxxSSSS--SSSSSSS--SSSSS?SS?SSSSS????SSSSSSSSS
]--SSSSSSSSS-------------------SSSSSSSSS----------
]--SSSSSSSSS---------<>--------SSSSSSSSS----------
]----XSSSSSS---------[]---------------------------
XXXXXXXXXXXXXXXXXXXXXXXXXXXXXXXXX-XX-XXXXXXXXXXXXX