-------------------------------------------xxxxx----------------------------------------------------
---------------------xxxxxxxxxxxxxxxxxxxxxxx----xxxxxxxxxxxxxxxxxxxxxxxx----------------------------
-------------------xxx-????SSSSSSSSSSSSSSSSS----SSSSSSSSSSSSSSSSSSSSSSSS----------------------------
----------------xxxxSS--------------------------SSSS------------------------------------------------
----------------xSSS----------------------------SSSS------------------------------------------------
----------------x-------------------------------SSSS----E-------------------------------------------
---------------xx--------------------------------------<>-------------------------------------------
--------------xxS------X-------------------------------[]------------E--------------------------xxx-
------------xxx-------XXXX-----------XXX----------E----[]-----------<>-------------------------xxXx-
S----------xx<>------XXXXX-----------------------<>---?SSS--E-------[]------------------------xxXX--
--xxx-----xx-[]-----XXXXXX-----------------------[]--------<>-------[]-S---------------E----ExxXXX-x
xxxS-x---xx--[]----XXXXXXX---XXX-----------------[]--------[]---<>--[]-S--------------------xxXXXX--
<>-S--xxxxS--[]---XXXXXXXX-----------------------[]--------[]---[]--[]-SxxxxxxxxxxxxxxxxxxxxxXXXXX--
XXXXXXXXXXXXXXXXXXXXXXXXXXX-----------------XXXXXXXXXX----XXX---XX--XX-SXXXXXXXXXXXXXXXXXXXXXXXXXXXX