XXX--XXXXE--XXXXXXXXXXXXXXXXXXXXXXXXXXXXXXXXXXX-XXEXXXXXXXX-XXXXXE--XXXXXXXXXXXXXXXXXXXXXXXXXXXXXXXY
----------------------------------------------------------------------------------------------------
----------------------------------------------------------------------------------------------------
SSSSSSSSSSSSSSSSSSSSSSSSSSSSSSSSSSSSSSSSSSSSSSSSSSSSSSSSSSSSSSSSSSSSSSSSSSSSSSSSSSSSSSSSSSSSSSSSSSSS
--------[]---------------------------------------------[--[]----[]----------------------------------
--------[]-------E-----------------xxx-----------------XXX[]----[]------E---------------------------
--------[]---QQQQQQ---------xxxxxxxx--x-------------------[]----[]---QQQQQ--------------xxx---------
--------[]-----------------xxSSSSSSS---xxxxx--------------[]----[]---------------------xx--x--------
--------[]----------------xx-SSSSSSS--SSSSS-x-------------[]----[]----------------xxx-xx----x-------
--------[]--xxxxxxxxxxxxxxx--SSSSSSS--SSSSS--xxxxxxx------[]----[]--xxxxxxxx-xxxxxx--xx--X---xx-----
--------[]-xxSSSSSSSSSSSSSS--SSSSSSS--SSSSS?SS?SSSSS------[]----[]-xxSSSSSSSx-]S]SS--QS--Q-E---xx---
xxx-----<>xx-SSSSSSSSSSSSSS-------SS----------SSSSSS------<>----<>xx-SSSSSSSSSSSSSS-------<>--<>-x--
[>-xxx---xx--SSSSSSSSSSSSSS-------SS<>--------SSSSSSx-----x-x---xxx--SSSSSSSSSSSSSS-------[]--[]--xx
X]----xxxx---SSSSSSSSSSSSSS---------[]---------------xxxxxxE-xxxxx---SSSSSSSSSSSSSS-------[]--[]---x