----------------------------------------------------------------------------------------------------
----------------------------------------------------------------------------------------------------
SSSSSSSSSSSSSSSSSSSSSSSS--SSSSSSSSSSSSSSSSSSSSSSSSSSSSSSSSSSSSSSSSSS?SSSSSSSSSSSSSSSSSSSSSSSSSSSSSSS
--------------------------SSSSSS---SSSSS--SSSS---S----SSSS------------------------------------------
--------------------------SSSSSS---SSSSS--SSSS---SE---SSSS------------------------------------------
--------------------------SSSSSS------SS---S------SS----------ooooooo-------------------------------
--------------------------------------SS---S------SS---------------------------------xx-------------
x-------------------------------------SS---S------SS----------SSSSSSS---------------xx-x-xxx--------
-x-------------------xxxxx--------ooooSS---So??--SSS---E------SSSSSSS--------------xx---xx--x-------
--x----xxxx---------xxXXX-xxxx----SSSSSS---SSS---SSS--SSSS-----------------------xxx----<>---x------
<>-x--xxSS-x-------xxEXXX-XXX-x----------------------E--------------------------xx<>----[]----xxx--x
[]--xxx-SS--x-----xxXXXXX------x----------------E--------xxxxx-----------------xx-[]----[]----<>-xxx
-]---x--SS---xxxxxxXXXXXX-------xxxxxxxxxxxxxxxxxxxxxxxxxx----xxxxxxxxxxxxxxxxxx--[]----[]--E-[]--x-
XXXXXX--XX--XXXXXXXXXXXX---XXXXXXXXXXXXXXXXXXXXXXXXXXXXXXX---XXXXXXXXXXXXXXXXXXXXXXXXXXXXXXXXXXXXXX-