----------------------------------------------------------------------------------------------------
----------------------------------------------------------------xx----------------------------------
---------SS--[]SSSSSSSSSSSXSSS----------------------------------------------------------------------
-------------[]SSSSSSSSSSS-SSS----------------------------------------------------------------------
-------------[]SSSSSSSSSSS-SSS----------------------------------------------------------------------
---xxx-------[]SSSSSSSSSSSSSSS-------------------E--------------------------------------------------
--xx--x------[]SSSSSSSSSSSSSSS------------------------------------E------------------------------XXX
-xx----x-----[]SSSSSSSSSSSSSSS------------------------------------------------------------------XXX-
xx------x-----]SSSSSSSSSSSSSSS-----------------------------------------------------------------XXXX-
x--------xxxx-]SSSSSSSSSSSSSSS-------E--EE----------E-------------------E--EE----<-E----------XXXXX-
-E-SSSS--SSSSSSSSSSSSSSSSSSSSS------<>--<>---------<>---------E--------<>--<>----[-<---------XXXXXX-
<>-SSSS--SSSSSSSSSSSSSSSSSSSSS--<>--[]--[]---------[]------------------[]--[]------]--------XXXXXXX-
[]-SSSS--SSSSSSSSSSSSSSSSSSSSS--[]--[]--[]---------[]------------------[]--[]------]-------XXXXXXXX-
XX-XXXXXXXXXXXXXXXXXXXXXXXXXXX--[]--[]--[]---------[]------S-----------[]--[]------]-----XXXXXXXXXX-