----------------------------------------------------------------------------------------------------
----------------------------------------------------------------------------------------------------
----------------------------------------------------------------------------------------------------
----------------------------------------------------------------------------------------------------
----------------------------------------------------------------------------------------------------
----------------------------------------------------------------------------------------------?Q----
-------------------------------------------------------------------------------E--------------------
?---------------------------------------------------------------E-----------------------------------
-------------------xxxxx-xxxxx-Exxxxx--xxx----------xx-------------------------xx-------xxx--QQ-----
----E-S--------xxxxx----xx----xxx----xxx--x--------xx-xxxxxxxxxxxxxxx---------xx-xxxxxxxx--x--------
--------------xx-XXX---XXX----XXX----XXX---x------xx--XXXXXXXXXXXXXX-x-------xx--XXXXXXXX---x-------
-------------xx--XX----XX------------XX-----xxxxxxx---X-----------XX--xxxxxxxx---------------xxxxxxx
xxxxxxxxxxxxxxX----------------------------XXXXXXXX---X-----------XX-XXXXXXXXX--------------XXXXXX-X
XXXXXXXXXXXXXXX----------------------------XX---------X-----------XX-X-------X--------------X-------