----------------------------------------------------------------------------------------------------
----------------------------------------------------------------------------------------------------
----------------------------------------------------------------------------------------------------
----------------------------------------------------------------------------------------------------
-----------------------------------------------------------xxxxxxxxxx-------------------------------
----------QQQQQ--------------------------------?----------xx-QQQ?QQQ-x-------SS---------------------
---------------------------------------------------------xx-----------x-----------------------------
-----------------------------------------------xxxxx----xx-----E-------x----------------------------
--xxxx--------------------------------------xxxx----x--xx----SSSSSSS----x------------xxx------------
-xx<>-x--E?QQQQ----------ooo--------------xxx--S-----xxx--------------E--x----------xx--x-----------
xx-[]--x---------------------------------xx<>---------x--------X------X---x---E----xx----x----------
x--[]---x-------------------------------xx-[]---X----<>--------X------X----x------xx------xx-------x
E--[]----xxxxxxxxxxxxxxxxxxxxxxxxxxxxxxxx--[]E--X----[]---E----X------X-----xxxxxxxX------X-xxxxxxxx
XXXXXXXXXXXXXXXXXXXXXXXXXXXXXXXXXXXXXXXXXXXXXXXXX----XXXXXXXXXXXXXXXXXXXXXXXXXXXXXXX------XXXXXXXXXX