----------------------------------------------------------------------------------------------------
----------------------------------------------------------------------------------------------------
-------------------SSSS--SSSSSSSSSSSSSSSSSSSSSSSSSSSSSSSSSSSSSSSSSSES-SSSSSSSSSSSSSSSSSSSSSSSSSSSSSS
-------------------]SSS------SS---SSSSSSSS------SSSS------------------------------------------------
-------------------]SSS------SS---SSSSSSSS--E---SSSS------------------------------------------------
------------------S]SSS----------------S----SS----------ooooo---------------Q-----------------------
------------------S]SSS----------------S----SS------------------------------------------------------
-------------------]SSS----------------S----SS----------SSSSS---------------------------------------
------------xxx---S]SSS------XE--------So??-SS---E------SSSSSo?----------------------------------xxx
xx---------xx--x--S]SSS------XQQ--QQQ--SSS--SS--SSSS-----------------------xxxx----xxxx---------xxXX
B-x-------xx----x-S>SSS------------------------EE-------------------------xx<>-x--xxSS-x-------xxEXX
b--x----Sxx------x-SSSS----------------------------xxxxx-----------------xx-[]--xxx-SS--x-----xxXXXX
>---xxxxxx------XX-SSSSxxxxxxxxxxxxxxxxxxxxxxxxxxxxx----xxxxxxxxxxxxxxxxxx--[]---x--SS---xxxxxxXXXXX
XXXXXXXXXX------XXXXXXXXXXXXXXXXXXXXXXXXXXXXXXXXXXXX---XXXXXXXXXXXXXXXXXXXXXXXXXXX--XX--XXXXXXXXXXXX