----------------------------------------------------------------------------------------------------
----------------------------------------------------------------------------------------------------
----------------------------]SSSSSSSSSSSS-----SSSSSSSSSSSSSSSSSSSSSSSSSSS-SSSSSSS----SSSSSSS--SSSSSS
----------------------------]SSSSSSSSSSSS-----SSSSSSSSSSSSSS----------------------------------------
----------------------------]SSSSSSSSSSSSxxxx-SSSSSSSSSSSSSS-------------------------------xxx----E-
--------------xxxxx---------]SSSSSSSSSSSSx---xSSSSSSSSSSSSSS----E------xxx---------xxxxxxxxx--xxxxxx
---------xxxxxxXXX-x--------]SSSSSSSSSSSSS----x----------------<>-----xx--x-------xx-SSSSSSS---SSSSS
--------xxXXXXXXXX--x-------]SSSSSSSSSSSSS-----x---------------[]----xx----x-----xx--SSSSSSS---SSSSS
-------xxXXXXXXXXX---x---xxx]SSSSSSSSSSSSS------x----x--------o[]--xxx------x---xx---SSSSSSS--oSSSSS
x-----xxXXXX----------x-xxS-]SSSSSSSSSSSSS-------xxxx-xxxx----SX]-xx<>-------xxxx----SSSSSSS--SSSSSS
-----xxXXXXX-----------xx---SSSSSSSSSSSSSS-------SSSSSS<>-x-----]xx-[]----E--SSSS--------SSS------S-
----xxXXXXXX-----------SSS-SSSSSSSSSSSSSSS--<>---SSSSSSb]--x---x]x--[]---<>--SSSS--------SSS------S-
oxxxxXXXXXX-----<>-----SSS-SSSSSSSSSSSSSSS--[]----------]---xxxx]---[]---[]---------------SS--------
XXXXXXXXXXX-----[]-----XXXXXXXXXXXXXXXXXXX--XX--XXXXXXXXXXXXXXXXXXXXXXXXXXXXXXXXX----XXXXXSXXXXXXXXX