--------------------------------------------------
--------------------------------------------------
--------------------------------------------------
--------------------------------------------------
-------------xxxxx--------------------------------
X--xx-----xxxx--X-x-------------------------------
--xx-x---xx--E--X--x-----------------------------x
-xx---x-xx---XX-X---x---------------------------xx
xx-----xx----XX-X----x--------------------xxxxxxx-
x------<>----XX-X-----x------------------xx-XXXXX-
E------[]----XX-X------x-----x----------xx--------
>------[]----XX-X-------S-----xxx------xx---------
]------[]----XX-X-------xxxxxxxE-xxxxxxx----------
XX-----XX-XXXXX-XXXXXXXXXXXXXX<>XXXXXXXX----------