----------------------------------------------------------------------------------------------------
----------------------------------------------------------------------------------------------------
----------------------------------------------------------------------------------------------------
----------------------------------------------------------------------------------------------------
--------------------xxx--------oo-------------------------------------------------------------------
SSSS---X-----------xx--x----------------------------------------------------------------------------
------------------xx----x---------------------------------------------------------------------------
-----------------xx------x--------------------------------------------------------------xxxxx-------
xx-------------xxx--o-----xxx--------------------------------------------------------xxxx-<>-x------
>-x-----------xx<>--------<>-x------------------------------------------------------xxQQ?-[]--x-----
---x---------xx-[]--------[]--x-----xxxx-----------------xxxx----------------------xx-----[]---x----
X---x-------xx--[]--------[]---x---xx<>-x---------------xx<>-x-------xxxxx-xxx----xx------[]----x---
X----xxxxxxxx---[]--------[]-E-Exxxx-[]-Exxxxxxxxxxxxxxxx-[]--xxxxxxxx----xx--xxxxx--X----[]-----xxx
XXXEXXXXXXXXXXXXXXXXXXXXXXXXXXXXXXXXXXXXXXXXXXXXXXXXXXXXXXXXXXXXXXXXXX---XXX--XXXXXXXXXXXXXXXXXXXXXX