-----------------------------------xxx---------xxx
--------------xxxx-------xxx------xx--x-------xx--
-------------xx---x-----xx--x----xx----x-----xx---
------------xx-----x---xx----x--xx------x---xx----
------------xx------x-xx------xxx--------xxxx-----
------------Sx-------xx-------XXX--------XXXX-----
----------xxxx-------XX---------------------------
xxxxx----xx--x-----------------------oo-----------
B----x--xx---S-----------------------SS-----------
b-----xxx-------XX--------------------------------
X------x------------------------------------------
Q-----<>---------------------o--------------------
S?----[]---E-----------------o---o----------------
XX----XXXXXXXXX--------------X---X--------------XX