----------------------------------------------------------------------------------------------------
----------------------------------------------------------------------------------------------------
SS--------------------------------------------------------------------------------------------------
[]--------------------------------------------------------------------------------------------------
[]--------------------------------------------------------------------------------------------------
[]---------------------------QS-----------------------------------------------------------------QQQQ
[]----------------------------------------------xxxx----------------------------------xxxx----------
[]---------------------------------------------xx---x--------------------------------xxXX-x---------
[]---xxx--------------------------------------xx-----xxx-------xxxx----S------------xxXXX--x--------
<>--xx--x--------------Q---S?SQS------------xxx------<>-x-----xx<>-x---------------xxXXXX---x--E?QSQ
---xx----x------------------------xxxx-----xx<>------[]--x---xx-[]--x-------------xxXXXXX----x------
--xx------xx---------------------xx<>-x---xx-[]------[]---x-xx--[]---x-----xxx---xxXXXXXX-----x-----
xxx------XX-xxxxxxxxxxxxxxxxxxxxxx-[]--xxxx--[]-E----[]----xx-E-[]----xxxxxx--xxxxXXXXXXX------xxxxx
XXX------XXXXXXXXXXXXXXXXXXXXXXXXXXXXXXXXXXXXXXXXXXXXXXXXXXXXXXXXXXXXXXXXXXX--XXXXXXXXXX--XXXXXXXXXX