--------------------------------------------------------------------------xxx-----------------------
-------xxxxxx-----------------------------------xx---------xxxx----------xx--x----------------------
------xx--<>-x---------------------------------xx-x-------xx---x--------xx----x---------------------
-----xx---[]--x-------------------------------xx---x-----xx-----xx-----xx------x--------------------
-----xx---[]---x-----------------------xxxxxxxx-----xxxxxx------E-xxxxxx--------xxxxx-----------xxx-
-----Sx---[]----xxxx----------------xxxx--XXXXX-----XXXXXX--------XXXXXX--------XXXXXx-------xxxx--x
---xxxx---[]----XXX-x--------------xxXXX----------------------------------------------x-----xxXXX---
--xx--x---XX---------xx------xxx--xx---------------------------------------------------x---xx-------
-xx---S-------------XX-x----xx--xxx-----------------------------------------------------x-xx--------
xx----------------------x--xx---XXX-----------XXX----------------------------------------xx---------
x------------------------xxx------------------------------------------------------------XXX---------
>-----------------------XXXXX-----------------------------------------------------------------------
]---E------------o----------------------------------------------------------------------------------
XXXXXXXX--------------XXXXXXX-----------------------------------------------------------------------