----------------------------------------------------------------------------------------------------
----------------------------------------------------------------------------------------------------
----------------------------------------------------------------------------------------------------
----------------------------------------------------------------------------------------------------
-------------xxx--------oo--------------------------------------------------------------------------
------------xx--x-----------------------------------------------------E---S----SSSSSSSS-------------
-----------xx----x---------------------------------------------------<>-----------------------------
----------xx------x--------------------------------------------------[]-----------------------------
--------xxx--o-----xxx-----------------------------------xxxx----S---[]-------------xxxx----------SS
-------xx<>--------<>-x---------------------------------xx<>-x-------XX------------xx--xxx-xxxx-----
------xx-[]--------[]--x-----xxxx----------------------xx-[]--x----------xxxx-----xx------xx---xxx--
<>---xx--[]--------[]---x---xx<>-x--------------------xx--[]---x--------xx<>-x---xx-------<>---<>-x-
xxxxxx---[]--------[]-E-Exxxx-[]-ExxxxxxxxxxxxxxxxxxxxxE--[]----xxxxxxxxx-[]--xxxx--------[]---[]--x
XXXXXXXXXXXXXXXXXXXXXXXXXXXXXXXXXXXXXXXXXXXXXXXXXXXXXXXXXXXXXXXXXXXXXXXXXXXXX-XXXX------XXXXX--XXXXX