----------------------------------------------------------------------------------------------------
----------------------------------------------------------------------------------------------------
----------------------------------------------------------------------------------------------------
----------------------------------------------------------------------------------------------------
---------------------------------------------------E----------------------------------------E-------
---------SSSS------------------------------------SSSSSSSS---SSSQ------------------------SSSSSS----S-
----------[]---ES-----------------------------------------------------------------------------------
----------[]------------------------------------E---------------------------------------------------
----------[]------------xxxx-----S----------------------------------<>-------------------E----------
----------[]-----------xx<>-x-----------------S?S--------------S----[]---------xxxxx---SSSSSSS---xxx
----------<>----------xx-[]--x------------------------------------------------xx-<>-x-----------xx<>
-xxx------xxx--------xx--[]---x-----xxxx--------------xxxxx----------------B-xx--[]--x---------xx-[]
xxB-xxxxxxxE-xxxxxxxxx---[]-E--xxxxxx---xxxxxxxxxxxxxxx----xxxxxxxxxxxxxxxxxxx---[]---xxxxxxxxxx--[]
XXbXXXXXXXXXXXXXXXXXXXXXXXXXXXXXXXXXX---XXXXXXXXXXXXXXX---XXXXXXXXXXXXXXXXXXXX--XXXXXXXXXXXXXXXXXXXX