----------------------------------------------------------------------------------------------------
-----------------------------xx-----------------------------------------------xx-----------xx-------
-E--------------------------xx-x---------------------------------------------xx-x---------xx-x------
---------------------------xx---x------xxx----------------------------------xx---x-E-----xx---x-----
---------------------xxxxxxx-----xxxxxxx--x-------------------x------xxxxxxxx-----x-----xx-----xxxxx
------------------xxxx---XXX-----XXXXXXXE--x------------------------xxXXXXXXX------xxxxxx------XXXXX
-----------------xxXXX----------------------x-------------E--------xx--------------XXXXXX-----------
----------------xx---------------------------x--------------------xx--------------------------------
------------xxxxx-----------------------------x-----------xx-xxxxxx---------------------------------
-----------xx-XXX--------XXX-------------------x---------xx-xx--XXX---------------------------------
x---------xx------------------------------------xxxxxx--xx--XX--------------------------------------
-x-------xx--------------------------------------x----xxx-------------------------------------------
X-xxxxxxxx-------------------------------XXXXEXXEX----XXX-------------------------------------------
XXXXXXXXXX------------------------------------------------------------------------------------------