----------------------------------------------------------------------------------------------------
----------------------------------------------------------------------------------------------------
SSSS-S----xx----------------------------------------------------------------------------------------
---------xx-x---------------------------------------------------------------------------------------
-x------xx---x--------------------------------------------------------------------------------------
-xxx---xx-----x-------------------------------------------------------------------------------xxxx--
-x--xxxx-------x----xxxxxxxxxx---------------------------------------------------------------xx---x-
xx--XXXX--------x--xxXXXXXXXX-x-------------------------------------------------------------xx-----x
xS---------------xxxXXXXXXXX---x----xx------------xxxxxxx-----xx-----------xx----------xxxxxx-------
Q-----------------xXXXX---------x--xx-x-xxxxxx---xx-XXXSxxx--xx-x-xxxxx---xx-x-xxxxx--xx-XXXX-------
S-----------------XXXXX----------xxx---xx-----x-xx---------xxx---xx----x-xx---xx----xxx-------------
S----------------XXXXXX-----------x----<>------xx-----------x----<>-----xx----<>-----x--------------
S---------------XXXXXXX---<>-----<>----[]------<>----------<>----[]-----<>----[]----<>--------------
XXXXXXX---------XXXXXX---x[]-----[]----[]------[]----------[]----[]-----[]----[]----[]--------------