-----------------------------------xxxxxx--------------------xx-------------------------------------
xxxxxxxxxxxxxxxxxxxxxxxxxxxxxxxxxxxx-XX--xxxxxxxxxxxxxxxxxxxxx--------------------------------------
SSSSSSSSSSSSSSSSSSSSSSSSSSSSSSSSSSSS-----SSSSSSSSSSSSSSSSSSSSS--------------------------------------
-----------------------------------------SSSSS------------------------------------------------------
-----------------------------------------SSSSS------------------------------------------------------
E----------------------------------------SSSSS---E------------------------------------SSSxoS--------
>----------------------------------------X------<>----------------------------------------x--------x
]-------------E---------------------------------[]------------E----------------------------x------xx
]------------<>---------E-------------------E---[]-----------<>-----------------------------x-xxxxx-
]----E-------[]--------<>------------------<>--?SSS--E-------[]------------xxx-----S---------xx--<>-
]---<>-------[]--<>----[]----------XXX-----[]-------<>-------[]-----------xxX-x--------------<>--[]-
X---[]---<>--[]--[]----[]---------XXXXX----[]-------[]---<>--[]-x-------Exx-X--x-------------[]--[]-
]---[]---[]--[]--[]----[]--------XXXX------[]-------[]---[]--[]--xxxxxxxxx--X---xxxxxxxxxx---[]--[]-
XX--XX---XX--XX--XX---XXX---XXXXXXXX----XXXXXXX----XXX---XX--XX--XXXXXXXXX--XXXXXXXXXXXXXXXXXXX--XX-