----------------------------------------------------------------------------------------------------
---------------------E------------------------------------------------------------------------------
--------------------------------------S-------------------------------------------------------------
xx--------------------------------------------------------------------------------------------------
--xxxxxxxxxx---------E------------------------------------------------------------------------------
--SSSSSSSSSxSSSSSSSSSSSSS----------SSSS---------------SSSS------------------------------------------
------------x----------------------------------------------E----------------------------------------
-------------x-----------------------------------------------------E--------------------------------
--------------x------E------X---------------xxxx------------------<>----------X-EE----X-------------
---------------x-----QQ?QQQQX--------------xx<>-x---SQS--QQ?QQQ---[]----------XSSSSSSSX-------------
----------------x----------------xxxx-----xx-[]--x----------------[---------------------------------
ooooooooo--------xx------------------x---xx--[]---x---------------[-----xxxx------------------------
ooooooooo--------X-xxxxxxxxxxxxxxx----xxxxE--[]----xxxxxxxxxxxxxxxxxxxxxx---xxxxxxxxxxxxxxxxxxxxxxxx
XXXXXXXXX--------XXXXXXXXXXXXXXXXX---XXXXXXXXXXX---XXXXXXXXXXXXXXXXXXXXXX---XXXXXXXXXXXXXEEXEXXXXXXX