----------------------------------------------------------------------------------------------------
----------------------------------------------------------------------------------------------------
-------------------------------------------------------------------SSSSSSSSSSSSSSSSSSSSSSSS---------
----------------------------------------------------------------------------------------------------
-E----------------------------------------------------xxxx------------------------------XXX---------
-SS-------------------xxxxx--------------------------xxXX-x----------------------------------ooSSSS-
-SS------------------xx-<>-x------------------------xxXXX--x--------------------------------XX------
-SS-----------------xx--[]--x----------------------xxXXXX---x----------------------------------xxx--
?SS---------------xxx---[]---x--------------------xxXXXXX----x--------------------------------xx--x-
?SX--------------xx<>--QQQ?---x------------------xxXXXXXX-----x---------------xxxx-----------xx----x
----------------xx-[]----------x-------xxxx-----xxXXXXXXX------x-------------xxSS-x---------xx------
---------xxx---xx--[]-----------x-----xx<>-x---xxXXXXXXXX-------x----------Exx-SS--x-------xx-------
xxxxxxxxxx--xxxx---[]------E-----xxxxxx-[]--xxxxXXXXXXXXX--------xxxxxxxxxxxx--SS---xxxxxxxx--------
XXXXXXXXXX--XXXXXXXXXX-----X---XXXXXXXXXXXXXXXXXXXXXXXXXXXXXXXXXXXXXXXXXXXXXX--XX--XXXXXXXXX--------