-------------------------------------------------------------------------------------------xxx------
------------------------------------------------------------------------------------------xx--x-----
--------------------------xxxxx--xxx------------------SS-----------X-XXXXX---------------xx----x----
-----------------------xxxx----xxx--x-----------------[]---------------[]----------xxxxxxx------x---
---------------x-----ExxXXX----XXX---x--E-------------[]---------------[]---------xx----x--------x--
------------------xxxxx---------------x---------------<>---------------[]---------xX----E---------x-
-----------------xx--x-----------------x-------------------------------[]--------xx----<>----------x
----------------xx---X------------------x--------------E---------------[]--------x-----[]-----------
-----xxxx-------x------------------------x----------xxxx---------------[]------xxx-----[]-----------
----xxSS-x------X-------------------------x--------xx<>-x-QQQQQQ?QQ?Q--<>---Q-xx<>-----[]-----------
---xx--]--x-----X---------------------------------xx-[]--x-------------------xx-[]-----[]-----------
x-xxSS-SS-------X-------------------------X------xx--[]---x-----------------xx--[]-----[]-----------
-xx-SS-SS--xxxxxX-------------------------Xxxxxxxx---[]----xxxxxxxxxxxxxxxxxx---[]-----[]------E----
XXXXXXXXXXXXXXXXX-------------------------XXXXXXXXXXXXXXXXXXXXXEXEXXXXXXXXXXXXXXXX-----XXXXXXX<>XXXX