----------------------------------------------------------------------------------------------------
----------------------------------------------------------------------------------------------------
----------------------------------------------------------------------------------------------------
----------------------------------------------------------------------------------------------------
---------xxxxxxxxxx--------------------------------xxxxxxxxxxx-----------E-E------------------------
--------xx--QQ?QQQ-x-------SSSSQ------------------xx--QQQ?QQQ-x-------SSSSSSSS-SS-xxxx-----xxx------
-------xx-----------x----------------------------xx------------x--------------E--xx---x---xx--x-----
------xx-----E-------x--------------------------xx------E-------x---------------xx-----x-xx----x----
----xxx-----SSSSSS----x-----------------------xxx-----SSSSSSS----x------------xxx-------xx---o-ox---
---xx<>-------X-----E--x----E?SQS------------xx<>--------------E--x----?-----xx<>-------<>-------xx-
B-xx-[]------XX-----X---x----------xxxx-----xx-[]-------X------X---x---E----xx-[]-------[]------<>-x
-xx--[]------XX-----X----x--------xx<>-x---xx--[]-------X------X----x------xx--[]-------[]------[]--
xxX--[]----E-XX-----X-----xxxxxxxxx-[]--xxxx---[]----E--X------X-----xxxxxxx---[]-------[]------[]--
XXXXXXXXXXXXXXXXXXXXXXXXXXXXXXXXXXXXXXXXXXXXXXXXXXXXXXXXXXXXXXXXXXXXXXXXXXXXXXXXX-------XX-XXXXXXXXX