--------------------------------------------------
--------------------------------------------------
SSSSSSSSSSSSSSSSSSSSSSSSSSSSSSSSSSSSSSSSSSSSSSSSSS
SS-------------------SS--SSSSSS--SSSS------SSSS---
SS-------------------SS--SSSSSS--SSSS--E---SSSS---
SS------oooo-------SS--------SS---S----SS---------
-------------------SS--------SS---S----SS---------
------S-SSSS-S-----SS--------SS---S----SS---------
x-----SoS--SoS-----SS----ooooSS---So??-SS---E-----
-x----SSS--SSS-----SSSS--SSSSSS---SSS--SS--SSSS---
X-x------------------SS-------------------EE------
X--x-----------------SS-----------------------xxxx
-E--xxxxxxxxxxxxxxxxxxxxxxxxxxxxxxxxxxxxxxxxxxx---
XEXXXXXXXXXXXXXXXXXXXXXXXXXXXXXXXXXXXXXXXXXXXXX---