----------------------------------------------------------------------------------------------------
---------------------------------------------------------------xxxx---------------------------------
--------------------------------------------------------------xx---xx-------------------------------
--------------------------------------------------------------x---<>-x------------------------------
--------------------------------------------------------------x---[]--x-----------------------------
-------X----------------------------Q-------------------------x---XX---x---------------------------X
--------------------------------------------------------------x---------x---------------------------
-----X------------------------------------------------x----xxxx----------x-----------------------X--
x----------------------------------------------------xx--xxx--S-----------x-------oo----------------
-xx---------------------------Q---S?SQS------------xxx--xx<>---------------x---------xxx------------
<>-x-------------------------------------xxxx-----xx<>-xx-[]----------------x-------xxX-x---xxxx----
[]--x----------xx-----------------------xx<>-x---xx-[]-x--[]--------------X--x-----xx-X--x-xx<>-x---
]]---xxxxxxxxxxxXxxxxxxxxxxxxxxxxxxxxxxxx-[]--xxxx--[]-E--[]--------------X---xxxxxx--X---xx-[]--xxx
XXXXXXXXXXXXXXXXXXXXXXXXXXXXXXXXXXXXXXXXXXXXXXXXXXXXXXXXXXXX-XXX----------XXXXXXXXXXXXXXXXXXXXX--XXX