----------------------------------------------------------------------------------------------------
----------------------------------------------------------------------------------------------------
----------------------------------------------------------------------------------------------------
----------------------------------------------------------------------------------------------------
----------------------------------------------------------------E-----------------------------------
-------------------------------------Q-------------------------SSSSSSS---SSSQ--------------?--------
----------------------------------------------------------------------------------------------------
-------------------------------------------------------------E--------------------------------------
----------------------------------------------------------------------------------------------------
--xxx---------------------------xxxx-?-----------------Q---S?SQ-------------S-----SS----Q--Q--Q-----
-xxX-x-------------------------xx<>-x---------------------------------------------------------------
xx-X--x-----------------------xx-[]--x-----xxx---------------------xxxxx----------------------------
x--X---xxxxxxxxxxxxxxxxxxxxxxxx--[]---xxxxxx--xxxxxxxxxxxxxxxxxxxxxx----xxxxxxxxxxxxxxxxxxxxxxxxxxxx
X--XXXXXXXXXXXXXXXXXXXXXXXXXXXXXXXXXXXXXXXXX--XXXXXXXXXXXXXXXXXXXXXX---XXXXXXXXXXXXXXXXXXXXXXXXXXXXX