----------------------------------------------------------------------------------------------------
----------------------------------------------------------------------------------------------------
--------------------------------------xxxx----------------------------------------------------------
------------------------------xxxxx--xx---x---------------------------------------------------------
-----------------------------xx----xxx-----xxxxxx----------------------------XXX--------------------
x---------SXQQ?QQQQ---------xxX-----x-------x----x------------------------------QQQ---------------X-
-x--------------[]---------xxXX----XX------XX-----x---------------------ES------[]------------------
----------------[]--------xxXXXXX------------------x----------------------------[]--------------X---
SS--------------[]-------xxXXXX---------------------xxxxx-----------------------[]-------xxxx-------
SS------SS--SSS-<>------xxXXXXX----------------------xXX-x----------------------[]------xx<>-x------
SS------SS-------------xxXXXXXX----------------------XXX--x-------xxx-----------<>-----xx-[]--x-----
SSx-----SS------xxx---xxXXXXXXX-E-------------------XXXX---x-----xxB-x----------xxx---xx--[]---x----
S--xxxxxxxxxxxxxxE-xxxxXXXXXXXX<>------------------XXXXX----xxxxxx-b--xxxxxxxxxxxE-xxxx---[]----xxxx
XXXXXXXXXXXXXXXX<>-XXXXXXXXXXXX[]------------------XXXXXXXXXXXXXXXXXXXXXXXXXXXXXXX-XXXXXXXXXXXXXXXXX