--------xxx-----------------------------------------------------------------------------------------
xxxxxxxxx--x----------------------------------------------------------------------------------------
XXXXXXXXX---x------------SSSSSSSSSSSSSSSSSSSSSSSSSSSSSSSSSSSSSSSSSSSSSSSSSSSSSSSSSSSSSSSSSSSSSSSS?SS
XXXXXXXXX----x-------------[]----[]----------------------------------------------SSSSSSSSSSSSSSSSSSS
XXXXXXXXX-----x------------[]----[]-------E---------------xxx--------------------SSSSSSSSSSSSSSSSSSS
XXXXXXXXX------x-----------[]----[]---QQQQQQ--------xxxxxxx--x-------------------SSSSSSSSSSSSSSSSSSS
XXXXXXXXX-------x----------<>----[]----------------xxSSSSSS---xxxx---------------------------S-----S
XXXXXXXXX--------x---------------[]---------------xx-SSSSSS--SSSS-x--------------------------S-----S
XXXXXXXXX---------x--------------[]--xxxxxxxxxxxxxx--SSSSSS--SSSS--xxxxxxxxxxxxxxxxxxxxx-----So???-S
XXXXXXXXX----------x-------------[]-xxSSSSSSSSSSSSS--SSSSSS--SSSS?SS?SSSSS???????SSSSSSSx----SSS---S
XXXXXXXXX-----------x------------<>xx-SSSSSSSSSSSSS-----------------SSSSSSSSSSSSS--------x----------
XXXXXXXXX------------x----xxx-----xx--SSSSSSSSSSSSS--------<>-------SSSSSSSSSSSSS---------x---------
XXXXXXXXX-----------X-xxxxx--xxxxxx---SSSSSSSSSSSSS--------[]------------------------------xxxxxxxxx
XXXXXXXXX--XXXXXXXXXXXXXXXX--XXXXXXE--XXXXXXXXXXXXXXXXXXXXXXXXXXXXXXXX-XX-XXXXXXXXXXXXXXXXXXXXXXXXXX