----------------------------------------------------------------------------------------------------
----------------------------------------------------------------------------------------------------
----------------------------------------------------------------------------------SSSSSSSSSSSSSSSSSS
------------------------------------------------------------------------------------------------SSSS
---------------------xxxxxxxxxxx----------E-E------------------xxxxx----------------------------SSSS
Q-------------------xx--QQQ?QQQ-x-------SSSSSSS-SS-xxxx-----xxxx--X-x----------------------SSS---S--
-------------------xx------------x-------------E--xx---x---xx--E--X--x---------------------SSS---S--
------------------xx------E-------x--------------xx-----x-xx---XX-X---x--------------------SSS---S--
----------------xxx-----S-SSSSS----x-----------xxx-------xx----XX-X----x-------------------SSS---So?
S---xxx--------xx<>--------------E--x---------xx<>-------<>----XX-X-----x------------------SSS---SSS
---xxX-x------xx-[]-------X------X---x---E---xx-[]-------[]----XX-X------x---Q----S?QQo-------------
--xxXX--x----xx--[]-------X------X----x-----xx--[]-------[]----XX-X-------S---SS--------------------
xxxXXX---xxxxx---[]----E--X------X-----xxxxxx---[]-------[]----XX-X-------xxxxxxxxxxxxxxxxxxxxxxxxxx
XXXXXXXXXXXXXXXXXXXXXXXXXXXXXXXXXXXXXXXXXXXXXXXXXX-------XX-XXXXX-XXXXXXXXXXXXXXXXXXXXXXXXXXXXXXXXXX