----------------------------------------------------------------------------------------------------
----------------------------------------------------------------------------------------------------
SSSSSSSSSSSSSSSSSSSSSSSSSSSSSSSSSSSSSSSSSSSSSSSSSSSSSSSSSSSSSSSSSSSSSSSSSSSSSSSSSSSSSSSSSSSSSSSSSSSS
SS-----------------------------------------------[SSSSSSSSSSSSSSSSSSSSSSS---------------------------
SS--------xxx------------------------------------[SSSSSSSSSSSSSSSSSSSSSSS---------------------------
SS-xxxxxxxx--x----------------xxx----------------SSSSSSSSSSSSSSSSSSSSSSSS---------------------------
--xxSSSSSSS---xxxxx----------xx--x-------------------------------------------------------xx---------
-xx-SSSSSSS---SSSS-x--------xx----x-------------------------xxxxx------xxx--------------xx-x-xxx----
xx--SSSSSSS--SSSSS--xxxxxxxxx------xxxxxxxxxxxxxxxxxxxxxxxxxx----xxxxxxxE-x------------xx---xx--x---
SS--SSSSSSS--SSSSS?SS?SSSSSSS-----SSS?SSSSS??????SSSSSSSSSSQ?----SQSSSSSS--x---------xxx----<>---x--
SS-------------------SSS[]-----------SSSSSSSSSSSS---------------------------x-------xx<>----[]----xx
SS---------<>--------SSS[]-----------SSSSSSSSSSSS-------------<>-------------x-----xx-[]----[]----<>
SS---------[]------------]------------------------------------[]--------------xxxxxx--[]----[]--E-[]
XXXXXXXXXXXXXXXXXXXXXXX-XXXXXXEXXXXXXXX-XX-XXXXXXXXXXXXXXXXXXXXXXXXXXXXX----XXXXXXXXXXXXXXXXXXXXXXXX