----------------------------------------------------------------------------------------------------
----------------------------------------------------------------------------------------------------
----------------------------------------------S-SSSSSS[[]-------------------------------------------
----------------------------------------------------------------------------------------------------
-------------------xxx-------------------------xxxx-----xxxxxx------------------------x------xxxxx--
------xxx-------E-xx<>xx----------------------xx---x---xxXXXX-x-----------------------xxxx--xxXXX-x-
-----xx--x-------xxX[]X-x--------------------xx-----x-xxXXXXX--x---------------------xx---xxxXXXX--x
----xx----x-----xxXX[]X--x------------------xx-------xXXXXXXX---x-----------------x-xx-----xXXXXX---
x-xxx------x--xxxXXX[]X---x---------------xxx-------XXXXXXXXX----x----------------xxx------XXXXXX---
-xx<>-------xxx<>XXX[]X----xx------------xx<>------XXXXXXXXXX-----x-------SSS----xx<>------XXXXXX---
<]>[]--------x-[]XXX[]X-----<xxx--------xx-[]-----XXXXXXXXXXX------x------------xx-[]------XXXXXX---
[]][]--------SX[]XXX[]X-----[]X-x-----Xxx--[]----XXXXXXXXXXXX-------xxx--------xx--[]------XXXXXX---
[]][]------X-XX[]XXX[]X-----[]X--xxxxxxx---[]----XXXXXXXXXXXX-------XX-xxxxxxxxx---[]------XXXXXX---
XXXXXXXXXXXXXXXXXXXXXXXXXXXXXXXXXXXXXXXXXXXXXXX-XXXXXXXXXXXXXXXXXXXXXXXXXXXXXXXXXXXXXX-----XXXXXXXXX