--------------------------------------------------
--------------------------------------------------
--------------------------------------------------
E-------------------------------------------------
----oo-------------------------------------xxxxxxx
---------------SSS?SSS--------QQ?---------xx--QQQ?
-----------------------------------------xx-------
----------------------------------------xx------E-
xx----------------------------SSS-----xxx-----SSSS
>-x------------SSSSSSS-------xxxx----xx<>---------
]--x-----xxxx---------------xx---x--xx-[]-------X-
]---x---xx<>-x-----xxxxxxxxxx-----xxx--[]-------X-
--E-Exxxx-[]-Exxxxxx---x---x-------x---[]----E--X-
XXXXXXXXXXXXXXXXXXXX-X-X---X-------XXXXXXXXXXXXXXX