----------------------------------------------------------------------------------------------------
----------------------------------------------------------------xxxxx-------------------------------
--------------------------------------oo-----------------------xx----x--------------------SS--------
--------------------------------------------------xxx-----xxx--xQ-----xxx-----------------[]--------
-----------------------------------------------xxxx-oxoooxx--xxx-----XXX-x--E-------------[]--------
--------------------------------------XXXX----xx-XX---x-xx----x-----------x---------------<>--------
------xxxx-----------------------------------xx--------xx-----XX-----------x------------------------
-----xxXX-x---------------------------------xx---------XX-------------------x--------------E--------
----xxXXX--x---------------------------xxxxxx--------------------------------x----------xxxx--------
---xxXXXX---x-----------------XXXX----xxXXXXX---------------------------------x--------xx<>-x-QQQQQQ
--xxXXXXX----x-----------------------xx-----------------------------------------------xx-[]--x------
-xxXXXXXX-----xx-------xxx----xxx---xx--------------------XXXXX---------------X------xx--[]---x-----
xxXXXXXXX-----X-xxxxxxxx--xxxxx--xxxx-----------------------------------------Xxxxxxxx---[]----xxxxx
XXXXXXXX--XXXXXXXXXXXXXX--XXXXX--XXXX---------XXXX--XXXX----------------------XXXXXXXXXXXXXXXXXXXXXX