--------------------------------------------------
--------------------------------------------------
--------------------------------------------------
--------------------------------------------------
--------------------------------------------------
SSSSS------------SS---SS-------------SSS-----E----
--------------------------------------------<>----
--------------------------------------------[]----
--xxxx---------SS--------------xxxxx--------[]----
-xx--xxx-xxx---------SSS---xxxxx-XX-xSSS----XXX--x
xx------xx--xxx-----------xxXX<>-XX--x----------xx
x-------<>--<>-x-xxxxx---xxXXX[]-XXX--x--------xx-
]-------[]--[]--xx----xxxxXXXX[]-XXX---xxxxxxxxx--
X-----XXXXXXXXXXXX-X-XXXXXXXX-XXXXXXXXXXXXXXXXXXXX