----------------------------------------------------------------------------------------------------
-x---------------------------------------------------xxxxxxxxxxxxxxxxxxxxxxxxxxxxxxxxxxxxxxxxxxxxxxx
xx---------------SSSSSSSSSSSSSSSSS-SSSSSSSSSS-------xxSSSSSSSSSSSSSSSSSSSSSSSSSSSSSSSSSSSSSSSSSSSSSS
xX-xxx-------------[]----[]------------------------xx-----------------------------------------------
xXxx--x------------[]----[]--------E---------xXXX-xx------------------------------------------------
xXxS---x-----------[]----[]---QQQQQQQ--------xxxxxxSSS-----------E----------------------------------
x-------x----------<>----[]-----------------xx---xS-------------<>----------------------------------
XX-------x---------------[]----------------xx-----SS-S----------[]----------------------------------
S---------x--------------[]--xxxxxxxxxxxxxxx------S-SS----------[]----------S-------------------E---
--SS-------x-------------[]-xxSSSSSSSSSSSSSS---------S-----E--SS[]--------E----E---------------<>---
------------x------------<>xx-SSSSSSSSSSSSSS--------------<>----[]---<>--<>---<>------------XX-[]--X
-------------x----xxx-----xx--SSSSSSSSSSSSSS--------------[]----[]---[]--[]---[]-----------XXX-[]--X
------------X-xxxxx--xxxxxx---SSSSSSSSSSSSSS--------------[]-E--[]---[]--[]---[]-------E-E-XXX-[]--X
XXXXXXXXXXXXXXXXXXX--XXXXXXE--XXXXXXXXXXXXXXXXXXXXXXXXXXXXXXXXXXXXXXXXXXXXXXXXXXXXXXXXXXXXXXX--XX--X