--------------------------------------------------
--------------------------------------------------
SSSSSSSSSSSS?SSSSSSSxx-----SSS?SSSSSSSSSSSSSSSSSSS
S---------------------x----SSS-----------------[]-
S----------------------xxx-SSS-----------------[]-
-------oooooo-------------xSSS-----------------[]-
---------------------------x--xxxxx------------<>-
-------SSSSSS---------------xxx----x--------------
-------SSSSSS----------------xX-----xx------------
S----------------ESSS--------XX----<>-x-----------
----------------------------XXX----[]--x----------
xxxxxxx--------------------XXXX----[]---x-----xxx-
x------xxxxxxxxxxxxxxx----XXXXX----[]----xxxxxx--x
X-----XXXXXXXXXXXXXXXX----XXXXX--XXXXXXXXXXXXXX--X