----------------------------------------------------------------------------------------------------
-----------------xxxxxxxxxxxxxxxxxxxxxxxxxxxxxxxxxxxxxxxxxxxxxxxxxxxxxxxxxxxxxxx--------------------
-SSSSSSS--------xxSSSSSSSSSSSSSSSSSSSSSSSSSSSSSSSSSSSSSSSSSSSSSSSSSSSSSSSSSSSSSS--------------------
---------------xx-----------------------------------------------------------------------------------
----------XXX-xx-----------------------------------------------------------------E------------------
QQ-------xxxx-xSSS-------------E------------------------------------------------------------------SS
--xx----xx---xx---------------<>--------------------------------------------------------------------
-xx-x--xx-----xS--------------[]--------------------------------------------------------------------
xx---xxx------S-S-------------[]-------S-------------E----------------XX-------------------------xxx
SS---QQQ---------S------E---SS[]SS---E-----------E--<>------------------------------------------xx--
SS---------------------<>-----[]----<>---<>-----<>--[]--------------XX--------SS---------------xx---
SS---------------------[]-----[]----[]---[]-----[]--[]-------------XXX--------SS--------------xx----
SS---------------------[]--E--[]----[]---[]-----[]--[]---------E-E-XXX--------SSxxxxxxxxxxxxxxx-----
XXXXXXXX------XXXXXXXXXXXXXXXXXXXXXXXXXXXXXXXXXXXXXXXXX--XXXXXXXXXXXX---------XXXXXXXXXXXXXXXXX-----