----------------------------------------------------------------------------------------------------
---------------------xxxxxxxxxxxxxxxxxxxxxxxxxxxxxxxxxxxxx------------------------------------------
SSSSSSSSSSSS--------xxSSSSSSSSSSSSSSSSSSSSSSSSSSSSSSSSSSS-x---SSSSSSSSSSSSSSSS--------------SSSSSSSS
SSS----------------xx--------------------------------------x--SSSS----------------------------[]----
SSS-----------XXX-xx----------------------------------------x-SSSS----------------------------[]----
SSS--QQ------xxxx-xSSS------------E--------------------------xSSSS-------------xx-------------[]----
------------xx---xx--------------<>---------------------------x---------------xx-xxx----------<>----
--xxx-xxx--xx-----xS-------------[]-----------E----------------x-------------xx--XX-x---------------
xxx--xx--xxx------S-S------------[]----------<>----------------oxxx------xxxxx-------x--------------
SSS--QQ--QQQ---------S------E--SS[]SS----E---[]---------------S?SS-x----xx-XXX--------x-------------
SSS------------------------<>----[]-----<>---[]--<>-----------SSS---x--xx--------------x------------
SSS------------------------[]----[]-----[]---[]--[]----<>-----SSS----xxx----------------x----xxx----
SSS------------------------[]-E--[]-----[]---[]--[]----[]-------E-EE--xX---------------X-xxxxx--xxxx
XXXXXXXXXXXX------XXXXXXXXXXXXXXXXXXXXX-XX---XX--XX--XXXXXXXXXXX-XXXXXXX---------XXXXXXXXXXXXX--XXXX