----------------------------------------------------------------------------------------------------
----------------------------------------------------------------------------------------------------
---------------------------------------------------SSSSSSSSSSSSSSS-?SSSSSSSS-SSS--------------------
----------------------------------------------------------------------------------------------------
--------------------------------------xxxx----------------------------------------------------------
------xxxxx--------------------------xxXX-x-------------------oooooo---------------------xxxxx------
-----xx-<>-x------------------------xxXXX--x--------------------------------------------xx-<>-x-----
----xx--[]--x----------------------xxXXXX---x-----------------SSSSSS-------------------xx--[]--x----
--xxx---[]---x--------------------xxXXXXX----x----------------SSSSSS-----------------xxx---[]---x---
-xx<>--QQQ?---x------------------xxXXXXXX-----x-------------------------------------xx<>--QQQ?---x--
xx-[]----------x-------xxxx-----xxXXXXXXX------x------------------------------>----xx-[]----------x-
x--[]-----------x-----xx<>-x---xxXXXXXXXX-------x--------xxxxx----------------]---xx--[]-----------x
EX-[]------E-----xxxxxx-[]--xxxxXXXXXXXXX--------xxxxxxxxx----xxxxxxxxxxxxxxxxxxxxx---[]------E-----
X-XXX------X---XXXXXXXXXXXXXXXXXXXXXXXXXXXXXXXXXXXXXXXXXXX---XXXXXXXXXXXXXXXXXXXXXXXXXXXX-----X---XX