----------------------------------------------------------------------------------------------------
-------------------------------------------xxx------------------------------------------------------
--------------E---------------------------xx--x-----------------------------------------------------
-----------------------------------------xx----xx---------------------------------------------------
----------------------------------------xx-----E-xxxxxx---------------------------------------------
-------SSSSSSS?S--------S----S--------xxx---------x----x-------SSSSSSS------------------------------
--------[]---------------------------xx-S--------<>-----x----------------------------------xxxx-----
--------[]--------------------------xx-----------[]------xxxx-----------------------------xx---x----
--------[]-------------xxxx--------xx------------[]-------xB-xxxxxxxxxxxxx---------------xx-----xxx-
--------[]------------xx<>-x------xx-------X-----XX-------XXXXESSSSSSEESS-x----QQQQ-----xx------<>-x
--------<>-----------xx-[]--x----xxE---------------------XXXXXX------<>----x------------<>------[]--
x-------xxx---------xx--[]---x--xx<>--------------------XXXXXXX------[]-----x----E------[]------[]--
XxxxxxxxxE-xxxxxxxxxx---[]----xxx-[]-----X-------------XXXXXXXX------[]------xxxxxxxxxxxx]-E----[]--
XXXXXXXXXXXXXXXXXXXXXXXXXXXXXXXXXXXXXXXXXX-------------XXXXXXXXXXXXXXXXXXXXXXXXXXXXXXXXXXXXXXXXXXXXX