----------------------------------------------------------------------------------------------------
----------------------------------------------------------------------------------------------------
----------------------------------------------------------------------------------------------------
----------------------------------------------------------------------------------------------------
-------------------E-----------E--------------------------------------------------------------------
-----------------SSSSSSSS---SSSSS-------------------------------------------------------------------
----------------------------------------------------------------------------------------------------
----------------E-----------------------------------------------------------------------------------
S-----------------------------------------------xxxx----S--S??--------------------------------------
--------------S?S---------------S---xxx--------xx<>-x----------------------------xxx----------------
-----------------------------------xxX-x------xx-[]--x--------------------------xxX-x---------------
----xxx---------------xxxxx-------xx-X--x----xx--[]---x-------xxx-----xxx------xx-X--x------------xx
xxxxx--xxxxxxxxxxxxxxxx----xxxxxxxx--X---xxxxx---[]----xxxxxxxx--xxxxxx--xxxxxxx--X---xxxxxxxxxxxxXX
XXXXX--XXXXXXXXXXXXXXXX---XXXXXXXXXXXXXXXXXXXXXXXXXXXXXXXXXXXXX--XXXXXX--XXXXXXXXXX-XXXXXXXXXXXXXX--