--------------------------------------------------
--------------------------------------------------
SSSSSSSSSSSSSSSSSSSS------------------------------
--------------------------------------------------
----------------------XXX-------------------------
--------------------------------------XXX---------
--------------------------------------------------
--------------------------------------------------
-----------------xxxxx-----SSSSS??----------------
---xxxx---------xxXXX-xxxx---------------------xxx
--xxSS-x-------xxEXXX-XXX-x-------------------xxX-
Exx-SS--x-----xxXXXXX------x------xxxx------Exx-X-
xx--SS---xxxxxxXXXXXX-------xxxxxxx---xxxxxxxx--X-
XX--XX--XXXXXXXXXXXX-------XXXXXXXX---XXXXXXXX--XX