----------------------------------------------------------------------------------------------------
----------------------------------------------------------------------------------------------------
SSSSSSSSSSSS-SSSSSSSSSSSSSSSSSSSSSSSSSSSSSSSSSSSSSSSSSSSSSSSSSSSSSSSSSSSSSSSSSSSSSSSSSSSSSSSSSSSSSSS
--------------------------------------------------SSSSSSSSSSSSSSSSSSSSSSSSSSSSSSSSSSSSSSSSSSSS---SSS
X----E-----------------oxxx-----------------------SSSSSSSSSSSSSSSSSSSSSSSSSSSSSSSSSSSSSSSSSSSS---SSS
QQQQQQQ--------xxxxxxxxxx--x----------------------SSSSSSSSSSSSSSSSSSSSSSSSSSSSSSSSSSSSSSSSSSSS---SSS
--------------xxSSSSSSSSS---xxxxxx----------------------------------------------------SSSS-------SSS
E------------xx-SSSSSSSSS--SSSSSS-x-----------------------------xxxxx------xxxxx-----xSSSS-------SSS
xxxxxxxxxxxxxx--SSSSSSSSS--SSSSSS--xxxxxxxxxxxxxxxxxxxxxxxxxxxxxx----xxxxxxx----xxxxxoSSS--------SSS
SSSSSSSSSSSSSS--SSSSSSSSS--SSSSSS?SS?SSSSSSSS?????SSSSSSSSSSSSSS?----SSSSSS?----SSSSSSSS--------?SSS
SSSSSSSSSSSSSS----------------------SSSXSS---SSSSS--------------------------------------------------
SSSSSSSSSSSSSS-----------<>---------SSS-SX---SSSSS----------------<>---------<>---------------------
SSSSSSSSSSSSSS-----------[]---------------------------------------[]---------[]-------------->------
XXXXXXXXXXXXXXXXXXXXXXXXXXXXXXXXXXXXXX-XXQ--XXXXXXXXXXXXEXXXXXXXXXXXXXXXXXXXXXXXXXXXXXXXXXXXXxxxXXXX