----------------------------------------------------------------------------------------------------
--------------------------------------------------------------------------E-------------------------
SSSSSS-SSSSSSSSSSSSSSSSSSSSSSSSSSSSSSSSSSSSSSSSSSSSSSSSSSSSSSSSSSSSSSSSSSSSSSSS?SSSSSSSSSSSSSSSSSSSS
SSS--------------------------------------------SSSSSSSSSSSSSSSSSSSSSSSSSSS------SSSSSSSSSSSSSSSS----
SSS-------------------xxx----------------------SSSSSSSSSSSSSSSSSSSSSSSSSSS------SSSSSSSSSSSSSSSS----
SSS-------------xxxxxxx--x---------------------SSSSSSSSSSSSSSSSSSSSSSSSSSS------SSSSSSSSSSSSSSSS----
---------------xxSSSSSS---xxxxx----------------------------------------------xxxxx------------------
x-------------xx-SSSSSS--SSSSS-x----------------------------xxxxx-------xxxxxx----x-----------------
-xxx---xxxxxxxx--SSSSSS--SSSSS--xxxxxxxxxxxxxxxxxxxxxxxxxxxxx----xxxxxxxxE--<>-----x------xxxxxxx---
?SS-xxxSSSSSSSS--SSSSSS--SSXSS?SS?SSSSSS???????SSSSSSSSSSSSS?----SSSSSSSSS--[]------x--xxxx-<><>-x--
SSS-SSSSSSSSSSS------------------SSSSSSSSSSSSSS-----------------------------[]-------xxxXXX-[][]--x-
SSS>SSSSSSSSSSS--------<>--------SSSSSSSSSSSSSS---------------<>------------[]-------EEXXXX-[][]---x
---]SSSSSSSSSSS--------[]-------------------------------------[]------------[]------E-XXXXX-[][]----
XXXXXXXXXXXXXXXXXXXXXXXXXXXXXXXXXxx-XXX-XXXXXXXXXXXXXXXXXXXXXXXXXXXXXXXXXXXXXXXX-XXXEXXXXXX-XXXXXXEX