x---------------------------------------------------------------------------------------------------
xxx-------------------------------------------------------------------------------------------------
]]-x------------------------------------------------------------------------------------------------
]---x-----------------------------------------------------------------------------------------------
]----x-------xxxxxxxxxx----------------------------------------xxxx----xxxx-------------------------
]-----x-----xx--QQQ?QQ-x-------------------X---------S--------xx---x--xxX--x-----------x------------
]------x---xx-----------x-----xxxx---------------------------xx-----xxx-X---x-----------x-----xxxx--
]-------x-xx------E------x---xx---x-------------------------xx-------xX-X----x-----------x---xx---x-
]--------xx-----SSSSSS----x-xx-----xxx---Q-QQ----------xxxxxx--------XX-X-----x-----------x-xx-----x
]--------<>-------------E--xx------<>-x-----------Q--xxx---<>-------XXXEX---S--x-----------xx------<
S--------[]-------X----<>--<>------[]--x-----xxxx---xx<>---[]------XXXXXX-------x----------<>------[
S--------[]-------X----[]--[]------[]---x---xx<>-x-xx-[]---[]-----XXXXXXX----X---xx--------[]------[
S--------[]----E--X----[]--[]------[]----xxxx-[]--xx--[]---[]----XXXXXXXX--------X-xxxxxx--[]-E----[
XXE------XXXXXXXXXXXXXXXXXXXXXXXXXXXXXXXXXXXXXXXX-XXX-XX--XXXXX-XXXXXXXXXXXXXXXXXXXXXXXXXXXXXXXXXXXX