--x-xxx-------------------------------------------
-xx----x------------------------------------------
S[S-----x-----------------------------------------
-[]------x----------------------------------------
-[]-------x---------------------------------------
-[]--------x--------------------------E--S----SSSS
-[]---------x-----xxxx---------------<>-----------
-[]----------x---xx---x--------------[]-----------
--]-----------x-xx-----xxx-----------[]-----------
x-]------------xx------<>-x-xxx-----SXXS----------
S-S------------<>------[]--xx--xxx------xxxx------
S-Sx-----<>----[]------[]-<>---<>-x----xx<>-xx---x
SxSx-----[]----[]------[]-[]---[]--xxxxx-[]---xxxx
XXXXX----[]----XXXXXXXXXXXXXXXXXXXXXXXXXXXXX-XXXXX