----------------------------------------------------------------------------------------------------
---X------------------------------------------------------------------------------------------------
SSSSSSSSSSSSSSSSSSSSSSSSSSSSSSSSSSSSSSSSSS?SSSSSSSSSSSSSSSSSSSSSSSSSSSSSSSSSSSSSSSSSSSSSSSSSSSSSSSSS
S---S-SS--SSSSSSS--SSSS------SSSS-------------------]]------[]--------------------------------------
----S-SS--SSSSSSS--SSSS--E---SSSS-------------------[]------[]--------E-----------------xxx---------
----SS---------SS---S----SS----------oooooo---------[]------[]----QQQQQQ----------xxxxxxx--x--------
----SS---------SS---S----SS-------------------------<>------[]-------------------xxSSSSSS---xxxxx---
----SS---------SS---S----SS----------SSSSSS-----------------[]------------------xx-SSSSSS--SSSSS-x--
----SS----oooooSS---So??-SS---E------SSSSSS-----------------[]---xxxxxxxxxxxxxxxxS-SSSSSS--SSSSS--xx
----SSSS--SSSSSSS---SSS--SS--SSSS---------------------------[]--xxSSSSSSSSSSSSSSS--SSSS----SSSSS?SS?
S-----SS--------------------EE------------------------------<>-xx-SSSSSSSSSSSSSSS------------------S
S-----SS------------------------xxxxx--------------xxx------xxxx--SSSSSSSSSSSSSSS--------<>--------S
xxxxxxxxxxxxxxxxxxxxxxxxxxxxxxxxx----xxxxxxxxxxxxxxx--xxxxxxxEx---SSSSSSSS-SSSSSS--------[]---------
XXXXXXXXXXXXXXXXXXXXXXXXXXXXXXXXX---XXXXXXXXXXXXXXXX--XXXXXXXXX---XXXXXXXXXXXXXXXXXXXXXXXXXXXXXXXXXX