----------------------------------------------------------------------------------------------------
-------------------------------------------------------------------------------------------xxx------
SSSSSSSSSSSSSSSSSSSSSSSSSSSSS-------------------------------------------------------------xx--x-----
-SSSSSSSSSSSSSSSSSSS---------------------------------------------------------------------xx----xx---
-SSSSSSSSSSSSSSSSSSS-------------------------------------xxxxx--------------------------xx----XX-x--
-SSSSSSSSSSSSSSSSSSS--QQ------xxxx----------------------xxXXX-x-------------------------x---------x-
-----------------------------xx---x--------------------xx-XXX--x------------------------x----------x
-------------------xxx-xxx--xx-----x---------------xxxxxX-XXX---x--------------------xxxx-----------
xxxxxxxxxxxxxxxxxxxx--xx--xxx-------x-------------xx--x-X-XXX----x-----------------xxx--S-----------
?S>SSSSSSSSSSSSSSSSS--QQ--QQQ--------x-----------xx---X-X-XXX-----x--------SSS----xx<>--------------
SSSSSSSSSSSSSSSSSSSS------------------x--------xxx----X-X-XXX------x-------------xx-[]--------------
SSSSSSSSSSSSSSSSSSSS--------------->---x------xx<>--X-X-X-XXX-------xxx---------xx--[]--------XX----
SSSSSSSSSSSSSSSSSSSS---------------]----xxxxxxx-[]--X-X-X-XXX-------XX-xxxxxxxxxx---[]--------------
XXXXXXXXXXXXXXXXXXXXXXXXXXXXX------]--XXXXXXXXXXXXXXX-X-X-XXXXXXXXXXXXXXXXXXXXXXXXXXXXXXXX----------