--------------------------------------------------
--------------------------------------------------
--------------------------------------------------
--------------------------------------------------
--------------------------------------------------
--------------------------------------------------
---------------------------------xxxx-------------
--------------------------------xxXX-x------------
-------------------------------xxXXX--x----xx-----
----xxxxx---------------------xxXXXX---x--xx-x-xxx
---xx-<>-x-------------------xxXXXXX----xxx---xx--
-Exx-X[]--x-----------------xxXXXXXX-----x----<>--
xxx--X[]-X-xxxxxxxxxxxxxxxxxxXXXXXXX----<>----[]--
XXX--XXXXXXXXXXXXXXXXXXXXXXXXXXXXXX-----[]----[]--