------------------------xxx-------------------------------------------------------------------------
-------------------xx--xx--x-------------------------------xx-----xx--------------------------------
------------------xx--xx----x-----------------------------xx-x---xx-x-------------------------------
---------------xxxx--xx------x---------------------------xx---xxxx---x------------------------------
--------xxx---xx-x---x--------x--------------------------x------x-----xxxx----------------------xxxx
-------xx--x-xx--S---E---------x------------------------Sx-----SS---E-XXX-x------------E-------xx---
------xx----xx------<>----------x------------------------x---------<>XXXX--x----------->------xx----
-----xx-----<>------[]-----------x-------------------xxxxx---------[]XXXX---x----------]-----xx-----
S--xxx--o---[]------[]--------S---x----------------xxx---x---------[]XXXX----x---------]---xxx------
--xx<>------XXX-----[]-------------x-------SSS----xx<>---SX--------[]XXXX-----x--------]--xx<>------
-xx-[]------------E-[]--------------x------------xx-[]-------E-----[]XXXX------x---------xx-[]------
xx--[]-----------<>-[]---------------xxx--------xx--[]------<>----X[]XXXX-------xxx-----xx--[]-----X
x---[]-----------[]-[]------E--------XX-xxxxxxxxx---[]------[]---XX[]XXXX-------XX-xxxxxx---[]----XX
XXXXXXXXXXXXXXXXXXXXXXXXXXX<>XXXXXXXXXXXXXXXXXXXXXXXXXXXXXXXXXXXXXXXXXXXXXXXXXXXXXXXXXXXXXXXXXXXXXXX