----------------------------------------------------------------------------------------------------
xxxxxxxxxxx-----------------------------------------------------------------------------------------
SSSSSSSSSS-x----------------------------------------------------------------------------------------
------------x-------------------------------------------------------------xxxxx---------------------
-------------x-----------------------------------------------------------xx----xxxxxx------------xxx
--------------x--------------------------------SSSSSSSS---------xxxx----xxX-----x----x--------xxxx--
---------------x-----------------------------------------------xx---x--xxXX----XX-----x------xx--E--
----------------x---------------------------------------------xx-----xxxXXXXX----------x----xx---XX-
------E----------x------------------------------E--E---------xxX------xXXXX-------------x-xxx----XX-
-----<>------XXX--x----------------------------SSSSSSSS-----xxEX------XXXXX--------------xx<>----XX-
-----[]--XXX-------x------------------Q?QQQ----------------xxXXX------XXXXX-------------E<>[]----XX-
oX---[]--XXX--------xx----------------------------xxx-----xxXXXX-----XXXXXX------------<>[][]----XX-
o----[]--XXX--------X-xxxxxxxxxxxxxxxxxxxxxxxxxxxxx--xxxxxxXXXXX----XXXXXXX<>----------[][][]----XX-
X----[]--XX--------XXXXXXXXXXXXXXXXXXXXXXXXXXXXXXXX--XXXXXXXXXXXXXXXXXXXXXX[]----------[]XXXXXXXXXX-