----------------------------------------------------------------------------------------------------
----------------------------------------------------------------------------------------------------
----------------------------------------------------------------------------------------------------
----------------------------------------------------------------------------------------------------
----------------------------------------------------------------------------------------------------
-----------x---------------------------------SSSSSSSSSSSSS-------------------SSSS?SS----------------
------------x---------------------------------------------------------------------------------------
-------------x-xxxxx-----------------------------xxxxxxx-----<>-------------------------------------
xx------------xx-<>-x---Q--Q--?----------------xxxSSSSS-x----[]-------------------------------X-EE--
X-x---------QQQ?-[]--x-------------S---------xxxSS-----S-x--QQQQQQ-----------SSSSSSSS---------XSSSSS
---x-------------[]---x-----------E---------xx<>----------x-----------------------------------------
----x------------[]----x------E----xxxxxx--xx-[]-----------x-xxxxx---xxx------------------xxx-------
EE-X-xxxxxxxx----[]-----xxxxxxxxxxxx---X-xxx--[]----E---EE--xx----xxxxE-xxxxxxxxxxxxxxxxxxx--xxxxxxx
XXXXXXXXXXXXXXXXXXXXXXXXXXXXXXXXXXXX---XXXXXXXXXXXXXXXXXXXXXXX-X-XXXXXXXXXXXXXXXXXXXXXXXXXX--XXXXXXX