----------------------------------------------------------------------------------------------------
----------------------------------------------------------------------------------------------------
------------------------------------------------------------X]XX------------------------------------
--------------------------------------------------------------[]-----------------------xxx----------
--------------------------------------------------------------[]---------------------xxx--x---------
QQQX----------------------------------------------------------[]--------------------xxXX---x--------
---X---------X------------------------------------------------[]-------oooo--------xx-XX----x-------
---X---------X------------------------------------------------[]-------oxxo-------xxX-XX-----x------
E--X---------X--E-X---------X-EE----X-------------ooo---------[]-------xx-xxxxxxxxx-X-XX------x-----
?SQX---------XSS?SX---------XSSSSSSSX-------------ooo---------<>------xx--XXXXXXEXXXX-XX-------x----
-----------------------------------------------------------------xxxxxx-----------XXX-XX--------x---
---E--------------------xxx-------------------------------------xxXXXXX-----------XXXXXX---------x--
xxxxxxxxxxxxxxxxxxxxxxxxx--xxxxxxxxxxxxxxxxxxxxxxxxxxxxxxxxxxxxxx-----------------XXXXXX--------X-xx
XXXXXXXXXXXXXXXXXXXXXXXXX--XXXXXXXXXXXXEEXEXXXXXXXXXXXXEEXEXXXXXX-----------------XXXXXXXXXXXXXXXXXX