----------------------------------------------------------------------------------------------------
----------------------------------------------------------------------------------------------------
SSSSSSSSSSSSSSSSSSSSSSS[SSSSSSSSSSSSSSSSSSSSSSSSSSSSSSSSSSSSSSSSSSSSSSSSSSSSSSSSSSSSSSSSSS----------
[]-----[-----------------------------------------------SSSSSSSSSSS----------------------------------
[]-----[-------E----------------xxx--------------------SSSSSSSSSSS--------------------------XXX-----
[]-----[---QQQQQQ---------xxxxxxx--x-------------------SSSSSSSSSSS----------------------------------
[]----<]-----------------xxSSSSSS---xxxxx-----------------------------------------------------------
[]----[]----------------xx-SSSSSS--SSSSS-x----------------------------------------------------------
[]----[]--xxxxxxxxxxxxxxx--SSSSSS--SSSSS--xxxxxxxxxx-xxxxxxxxxxxxxx--------------------xxxxx-----SSS
[]----[]-xxSSSSSSSSSSSSSS--SSSSSS--SSSSS?SS?SSSSS??????SSSSSSSSSSS-x-----xxxx---------xxXXX-xxxx----
<>----->xx-SSSSSSSSSSSSSS------------------SSSSSSSSSSSS-------------x---xxSS-x-------xxEXXX-XXX-x---
xxx----xx--SSSSSSSSSSSSSS--------<>--------SSSSSSSSSSSS-----------<>-x-xx-SS--x-----xxXXXXX------x--
xE-xxxxx---SSSSSSSSSSSSSS--------[]-------------------------------[]--xx--SS---xxxxxxXXXXXX-------xx
XX-XXXXXE--XXXXXXXXXXXXXXXXXXXXXXXXXXXXXXXXXX-XX-XXXXXXXXXXXXX?XXXXXXXXX--XX--XXXXXXXXXXXX-------XXX