--------------------------------------------------
--------------------------------------------------
-------------------------------------------------S
-------------------------------XX-----------------
---------------------------xxxxx------------------
------------------------E-xxXXX-x-----------------
-----xxxxx---------------xxXXXX--x----------------
----xxXXX-x-------------xxXXXXX---x---------------
--xxxXXXX--x----------xxxXXXXXX----x--------------
-xxX>XXXX---x--------xx<>XXXXXX-----x--------SSS--
xxXX]XXXX----x------xx-[]XXXXXX------x------------
xXXX]XXXX-----x----xx-X[]XXXXXX-------xxx---------
XXXX]XXXX------xxxxx-XX[]XXXXXX-------XX-xxxxxxxxx
XXXXXXXX--XXXXXXXXXXXXXXXXXXXXXXXXXXXXXXXXXXXXXXXX