----------------------------------------------------------------------------------------------------
----------------------------------------------------------------------------------------------------
-----------------SSSSSSSSSS--[]SSSSSSSSSSSSSSS------------------------------------------------------
-----------------[]----------[]SSSSSSSSSSSSSSS------------------------------------------------------
-----------------[]----------[]SSSSSSSSSSSSSSS------------------------------------------------------
---------SSSS----[]----------[]SSSSSSSSSSSSSSS----------------------------------XXXX----------------
----------[]-----------------[]SSSSSSSSSSSSSSS---------------XX-------------------------------------
----------[]-----------------[]SSSSSSSSSSSSSSS--------------XXX-------------------------------------
----------[]------------------]SSSSSSSSSSSSSSS-------------XXXX-------------xxxxxxxxxxx-------------
xx--------[]-----------xxxxxx-]SSSSSSSSSSSSSSS------------XXXXX------------xxXXXXEXXXX-x------------
B-x-------<>----------xxSSSSSSSSSSSSSSSSSSSSSS-----------XXXXXX----------xxx------------x-----------
b--x------xxx--------xx-SSSSSSSSSSSSSSSSSSSSSS------<>--XXXXXXX---------xxXXX------------x-xx-------
B---xxxxxxxE-xxxxxxxxx--SSSSSSSSSSSSSSSSSSSSSS------[]-XXXXXXXX--------xx-----------------xxXxxxxxxx
XXXXXXXXXXXXXXXXEXXXXXXXXXXXXXXXXXXXXXXXXXXXXX------XXXXXXXXXXX-------XXXXXXX--------XXXXXXXXXXXXXXX