----------------------------------------------------------------------------------------------------
----------------------------------------------------------------------------------------------------
--------------------------------------------------------------------------------------------------E-
----------------------------------------------------------------------------------------------------
---------------------------------------------------E------------------------------------------------
B------------------------------------------------SSSSSSSS---SSSQ--------------?------------SSSSSSS?S
b-------------------------------------------------------------------------------------------[]------
xx----------------------------------------------E-------------------------------------------[]------
--x--------------------xxxx----S------------------------------------------------------------[]------
---x--------xxx-------xx<>-x------------------S?S--------------S-----SS----Q--Q--Q----S-----[]------
----x------xxX-x-----xx-[]--x---------------------------------------------------------------<>------
o----x----xx-X--x---xx--[]---x------xxx---------------xxxxx---------------------------------xxx-----
o-----xxxxx--X---xxxx---[]----xxxxxxx--xxxxxxxxxxxxxxxx----xxxxxxxxxxxxxxxxxxxxxxxxxxxxxxxxxxE-xxxxx
XXXXXXXXXXXXXXXXXXXXXXXXXXXXXXXXXXXXX--XXXXXXXXXXXXXXXX---XXXXXXXXXXXXXXXXXXXXXXXXXXXXXXXXXXXXXXXXXX