----------------------------------------------------------------------------------------------------
----------------------------------------------------------------------------------------------------
-------------------------------?--------------------------------------------------------------------
--------------------------------------------------XX------------------------------------------------
------------------------------------------------xxxx------------------------------------------------
--------------SSSSS-------------------xxxxx----xxXX-x-----------------------------------------------
---------------------------------SS--xx----x--xxXXX--x---------------------------------------------x
------------------------------------xxX-----xxxXXXX---x-------------------------------------------xx
B---E----------E-------------SS----xxXX------xXXXXX----x-----------------------------------------xx-
--------------SSSSS-xxx-----------xxXXX------XXXXXX-----x---------------------E--S--------------xxX-
x------xxxx--------xxX-x--B------xxXXXX-----XXXXXXX------x-------------------<>---------E--E---xxXXX
-x----xx<>-x------xx-X--x-b----xxxXXXXX----XXXXXXXX-------x-------xxx------------------<>-->--xxXXXX
--xxxxx-[]--xxxxxxx--X---xxxxxxx-XXXXXX---XXXXXXXXX-------Xxxxxxxxx--xxxxxxxxxxxxxxxxxxxxxxxxxxXXXX-
XXXXXXXXXXXXXXXXXXXXXXXXXXXXXXXX-XXXXXXXXXXXXXXXXXXXXXXXXXXXXXXXXXX--XXXXXXXXXXXXXXXXXXXXXXXXXXXXXX-