----------------------------------------------------------------------------------------------------
----------------------------------------------------------------------------------------------------
------------------------------------------------------------E---------------------------------------
-----------------------------------------------------------<>--------------------------------------x
-----------------------------------------------------------[]-------------------------------------xx
--------------XX------------------------------E-E-E--------[]-----------xxxxx--------------------xxX
--------------[]-----------------------------<><><>--------------------xx-<>-x------------------xxXX
--------------[]-----------------------------[][][]-------------x-----xx--[]--x-------------xxxxxXXX
--xxxx--------[]-------------------------Q?--QQQQQQ-------------x---xxx---[]---x-----------xx--xXXXX
-xx---xx------<>SSSSSS------------------Q-------------------------xxx<>--QQQ?---x---------xx----XXXX
xx----X-x----------------------------------------------xxxx------xx<>[]----------x-------xx----XXXXX
x-----XX-xxx---Exxx-----------------------xxx---------xx<>-x-----x-[][]-----------x-----x<>---XXXXXX
B-----XXXXX-xxxxxE-xxxxxxxxxxxxxxxxxxxxxxxx--xxxxxxxxxx-[]--xxxxx--[][]------E-----xxxxxx[]---XXXXXX
X-----XXXXXXXXXX<>XXXXXXXXXXXXXXXXXXXXXXXXX--XXXXXXXXXXXXXX-XXXXXXXXXXXX-----X---XXXXXXXXXXXXXXXXXXX