-------------------------------xxxxxx---------------------------------------------------------------
xxxxxxxxxxxxxxxxxxxxxxxxxxxxxxxx-XXX-xxxxxxxxxxxxxxxxxxxxxxxxxxxx-----------------------------------
SSSSSSSSSSSSSSSSSSSSSSSSSSSSSSSS-----SSSSSSSSSSSSSSSSSSSSSSSSSSSS------------SSSSSSSSSSS---SSS---SSS
SSS--SSS-----------------------------SSSSSSSSSSSSSSSSS-----------------------SSSSS------------------
SSS--SSS-----------------------------SSSSSSSSSSSSSSSSS-----------------------SSSSS------xxxx--------
SSS----------------------------------SSSSSSSSSSSSSSSSS-----E---------------------------xx---x-------
-------------------------------------S--------------------<>-------------------------xxx-----xx-----
-------------------------------------S--------------------[]-------------------o-----xXX-----S-x----
<>------------------E-----------------?ooooooooooo--------[]--------------------E----xXX-----S--x---
[]--------------E--<>-----------------??SSSSSSSSSS----XX--[]-----------------SSSSS--xxXX---------xxx
S]-------E-----<>--[]----------XX--------------------XXX--[]---SS--------E---E-----xxXXX---------SSS
S]------<>-----[]--[]---------XXXXXX----------------XXXX--[]---SS----------------Exx-XXX---------SSS
-X------[]---E-[]--[]--------XXXX------------EE----XXXXX--[]---SSxxxxxxxxxxxxxxxxxx--XXX---------SSS
XXXXXXXXXXXXXXXXXXXXX--XXXXXXXXX-----XXXXXXXXXXXXXXXXXXXXXXXX--XXXXXXXXXXXXXXXXXXXXXXXXX---------XXX