----------------------------------------------------------------------------------------------------
-----------------------------------------------------------------------xxxxxxxxxxxxxxxxxxxxxxxxxxxxx
SSSSSSSSSSSSSSSSSSSSS---SSSSSSSSSSSSSSSSSSSSSSSSSSSSSSSSSSSSSS--------xxSSSSSSS-SSSSSSSSSSSSSSSSSSSS
SSSSSSSSSSSS-------[]---SSSSSSSSSSSSSSSSSSS-SSSSSSSSS--]-------------xx-----------------------------
SSSSSSSSSSSS-------[]---SSSSSSSSSSSSSSSSSSS?SSSSSSSSS--Q--------XXX-xx------------------------------
SSSSSSSSSSSS-------[]---SSSSSSSSSSSSSSSSSSSSSSSSSSSSS--QQ------xxxx-xSSS-----------E----------------
-------------------[]-----------------------------------------xx---xx-------------<>----------------
xxx----------------[]---------xxx-------------------xxx-xxx--xx-----xS------------[]----------------
---xx-xxxxxxx------[]---xxxxxxx?-xxxxxxxxxxxxxxxxxxxx--xx--xxx------S-S-----------[]-------S--------
-----xx><><>-x-----[]--xx-SSSSS??SSSSSSSSSSSSSSSSSSSS--QQ--QQQ---------S-----E--SS[]SS---E----E-----
----XXX][][]--x----<>-xx--SSSS---SSSSSSSSSSSSSSSSSSSS-----------------------<>----[]----<>---<>-----
>--XXXX][][]---x-----xx---SSSS---SSSSSSSSSSSSSSSSSSSS-----------------------[]----[]----[]---[]-----
]--XXXX][][]-]--xxxxxx--------oooSSSSSSSSSSSSSSSSSSSS-----------------------[]-E--[]----[]---[]-----
XXXXXXXXXXXXXXEXXXXXXX---XXXXXXXXXXXXXXXXXXXXXXXXXXXXXXXXXXXXX------XXXXXXXXXXXXXXXXXXXXXXXXXXXXXXXX