---------------------------------------------------------------------------------------------xxx----
--------------------------------------------------------------------------------------------xx--x---
-------------------------------------------------------------------------------------------xx----x--
------------------------------------------------------------------------------------------xx------x-
--------------------------------------------------xxxxxxxxxxx----------E-E---------------xx--------x
SSSS-------------------SSS?SSS-------QQ?---------xx--QQQ?QQQ-x-------SSSSSSS-SS-xxxx-----xX--------X
------------------------------------------------xx------------x-------------E--xx---x---xx----------
xx-----<>--------------------------------------xx------E-------x--------------xx-----x-xx-----------
S-x----[]----------------------------SSS-----xxx-----SSSSSSS----x-----------xxx-------xx------------
---x--QQQQQQ-----------SSSSSSS------xxxx----xx<>--------------E--x---------xx<>-------<>------------
----x------------------------------xx---x--xx-[]-------X------X---x---E---xx-[]-------[]-----E-----E
-----x-xxxxx---xxx---------xxxxxxxxx-----xxx--[]-------X------X----x-----xx--[]-------[]----<>----<>
--EE--xx----xxxxE-xxxxxxxxxx---x--x-------x---[]----E--X------X-----xxxxxx---[]-------[]----[]----[]
XXXXXXXX-X-XXXXXXXXXXXXXXXXX-X-X--X-------XXXXXXXXXXXXXXXXXXXXXXXXXXXXXXXXXXXXX-------XX-XXX[]X--X[]