----------------------------------------------------------------------------------------------------
----------------------------------------------------------------------------------------------------
--------------------------------------------------SSSSSSSSSSSSSSSSSSSSSSSSSSSSSSSSSSSSSSSSSSSSSSSSS-
---------------------------------------------------------------[-SSSSSSSSSSSSSSSSSSSSSSSSS----------
----------------------------------xxxx-------------------------[-SSSSSSSSSSSSSSSSSSSSSSSSS----------
---------------------------------xxXX-x------------------------<-SSSSSSSSSSSSSSSSSSSSSSSSS--QQ------
--------------------------------xxXXX--x-----------------------------------------------------------x
-------------------------------xxXXXX---x--------------------------------xxx-------------xxx-xxx--xx
----E-------------------------xxXXXXX----x-----------------------xxxxxxxxx?-xxxxxxxxxxxxxx--xx--xxx-
---->------------------------xx-XXXXX-----x---------------------xx-SSSSSSS??SSSSSSSSSSSSSS--QQ--QQQ-
x--------------------------xxx--XXXXX------x-------------------xx--SSSSS----SSSSSSSSSSSSSS----------
-x-----------xxxxx-xxx----xx<>-XXXXXX-------xxx--------xxx-xxxxx---SSSSS----SSSSSSSSSSSSSS----------
-Xxxxxxxxxxxxx----xx--xxxxx-[]XXXXXXX-------XX-xxxxxxxxx--xx--x---------ooooSSSSSSSSSSSSSS----------
XXXXXXXXXXXXXX---XXX--XXXXXXXXXXXXXXXXXXXXXXXXXXXXXXXXXX--XX--X---XXXXXXXXXXXXXXXXXXXXXXXXXXXXXXXXX-