--------------------------------------------------
--------------------------------------------------
--------------------------------------------------
--------------------------------------------E-----
--------------------------------------------------
-----------------------------XXX------------------
---------------XXXoo--------------------XXX-------
----------------------X---------------------------
---xxx--------------------------------------------
--xx--x----------------------------XXX-------XXXXX
-xx----x------------------------------------------
xx------x-----------------------------------------
x--------xxxxx------------------------------------
X--------XXXX-------------------------------------