----------------------------------------------------------------------------------------------------
---------------------------------------E------------------------------------------------------------
SSSSSSSSSSSSSSSSSSSSSSSSS-S?SSS-SSSSSSSSSSSSSSSSSSSSS???SSSSSSSSSSSSSS------SSS---------------------
SSSSSS------SSSS------------------------------------------------------------------------------------
SSSSSS--E---SSSS------------------------------------------------------------------------------------
SSSSSS--SS----------oooooooo--------------------------------------------------------------X-SS------
---S----SS-------------------------------------------XXX-------------------------XX---------------XX
---S----SS----------SSSSSSSS------------------------XXXX------------------------XXX-----------------
---So??-SS---E------SSSSSSSS-------------E---------XXXXX-----E-----------------XXXX-----------------
---SSS--SS--SSSS------------------------<>--------XXXXXX---QQQQ---------------XXXXX-----------------
B----------EE---------------------------[]-------XXXXXXX---------------------XXXXXX-----------------
b--------------xxxxx-------------------x]]------XXXXXXXX------------<>------XXXXXXX-----------------
xxxxxxxxxxxxxxxx----xxxxxxxxxxxxxxxxxxxx]]-----XXXXXXXXXE-----------[]------XXXXXXX-----------------
XXXXXXXXXXXXXXXX---XXXXXXXXXEEXXXXXXXXXXXXX--XXXXXXXXXXXXXXXXXX----XXXXXXXXXXXXXXXX-----------------