----------------------------------------------------------------------------------------------------
----------------------------------------------------------------------------------------------------
SSSSSSSSSSSSSSSSSSSSSSSSSSSSSSSSSSSSSSSSSSSSSSSSSSSSSSSS?SSSSSSSSSSSSSSSSSSSSSSSSSSSSSSSSSSSSSSSSSSS
---]SSSSSSSS---------SS--SSSSSS--SSSS------SSSS-----------------------------------------------------
---]SSSSSSSS---------SS--SSSSSS--SSSS--E---SSSS-----------------------------------------------------
---SSSSSSSSS------xxx--------SS---S----SS----------oooooo-------------------------------------------
------------------SSS-S------SS---S----SS--------------------------------xx-------------------------
------------------SSS--------SS---S----SS----------SSSSSS---------------xx-x-xxx--------------------
xxxxxxxxxxxxx-----SSS----ooooSS---So??-SS---E------SSSSSS--------------xx---xx--x-------------------
???SSSSSSSSS-x----SSSSS--SSSSSS---SSS--SS--SSSS----------------------xxx----<>---x------xxxx--------
SSS-----------x------SS-------------------EE------------------------xx<>----[]----xxx--xxSS-x-------
SSS<-----------x-----SS-----------------------xxxxx----------------xx-[]----[]----<>-xxx-SS--x-----x
----------------xxxxxxxxxxxxxxxxxxxxxxxxxxxxxxx----xxxxxxxxxxxxxxxxx--[]----[]--E-[]--x--SS---xxxxxx
XXXXXXXXXXXXXXXXXXXXXXXXXXXXXXXXXXXXXXXXXXXXXXX---XXXXXXXXXXXXXXXXXXXXXXXXXXXXXXXXXXXXX--XX--XXXXXXX