----------------------------------------------------------------------------------------------------
----------------------------------------------------------------------------------------------------
----------------------------------------------------------------------------------------------------
----------------------------------------------------------------------------------------------------
----------------------------------------------------------------------------------------------------
------------------------------------SSSSSS-----QQ---------------SSSS--------SSSSS-------------------
----------------------------------------------------------------------------------------------------
-----xxxxx------------------------------------------------------------------------------------------
--xxxx-<>-x-----Q--?-----------------xxxx---------------------------xxxx----------------------------
-xxQQ?-[]--x-------------S----------xx<>-x----QQQ--------------S---xx<>-x-QQQQ--QQ?QQ--------------x
xx-----[]---x----------E-----------xx-[]--x-----------------------xx-[]--x------------------------xx
x------[]----x-----E-----xxxxxxx--xx--[]---x------E-xxxx---------xx--[]---x--------------xxx-----xx-
-oX----[]-----xxxxxxxxxxxx----X-xxx---[]----xxxxxxxxx---xxxxxxxxxx---[]----xxxxxxxxxxxxxxx--xxxxxx--
XXXXXXXXXXXXXXXXXXXXXXXXXX----XXXXXXXXXXXXXXXXXXXXXXX---XXXXXXXXXXXXXXXXXXXXXXXXXXXXXXXXXX--XXXXXXXX