----------------------------------------------------------------------------------------------------
--------------------------------------------------------------------------xxxxxxxxxxxxxxxxxxxxxxxxxx
-----------------SSSSSSSSSSSSSSSSSSSSSSSSSSSSSSSSSSSSSSSSSSSSSSSS--------xxSSSSSSSSSSSSSSSSSSSSSSSSS
-------------------------------SSSSSSSSSSSSSSSSSSSSSSSSS----------------xx--------------------------
-------------------------------SSSSSSSSSSSSSSSSSSSSSSSSS-----------XXX-xx---------------------------
-----xxxx----------------------SSSSSSSSSSSSSSSSSSSSSSSSS--QQ------xxxx-xSSS------------------E------
----xxXX-x-------------------------------------------------------xx---xx--------------------<>------
---xxXXX--x---------------------------xxx--------------xxx-xxx--xx-----xS-------------------[]------
--xxXXXX---x-------------------xxxxxxxx?-xxxxxxxxxxxxxxx--xx--xxx------S-S------------------[]------
-xxXXXXX----x-----------------xx-SSSSSS??SSSSSSSSSSSSSSS--QQ--QQQ---------S------------E--SS[]SS---E
xxXXXXXX-----x---------------xx--SSSSS---SSSSSSSSSSSSSSS-------------------------E----<>----[]----<>
xXXXXXXX------x------xxx-xxxxx---SSSSS---SSSSSSSSSSSSSSS------------------------<>----[]----[]----[]
XXXXXXXX-------xxxxxxx--xx--x---------oooSSSSSSSSSSSSSSS------------------------[]----[]-E--[]----[]
XXXXXXXXXXXXXXXXXXXXXX--XX--X---XXXXXXXXXXXXXXXXXXXXXXXXXXXXXXXXX------XXXXXXXXXXXXXXXXXXXXXXXXXXXXX