----------------------------------------------------------------------------------------------------
----------------------------------------------------------------------------------------------------
----------------------------------------------------------------------------------------------------
-----------------------------------------------------xxx--------------------------------------------
-----xxxxxxxxxxx----------E-E----------------------xxx--x-------------------------------------------
----xx--QQQ?QQQ-x-------SSSSSSS-SS-xxxx-----xxxx--xxXS---x------------------------------------------
---xx------------x-------------E--xx---x---xx---xxxEX-----x-----------------------------------------
--xx------E-------x--------------xx-----x-xx-----xXXX------x---------------E------------------------
-xx-----SSSSSSS----x-----------xxx-------xx------XXXXS------x--------------------B------------------
xx>--------------E--x---------xx<>-------<>-----XXXXX--------x----------B--------b------------------
<>]-------X------X---x---E---xx-[]-------[]----XXXXXX---------x---------b--?-B-------?QQ------------
[]]-------X------X----x-----xx--[]-------[]----XXXXXX----------x--------B----b-------------------xxx
E]]----E--X------X-----xxxxxx---[]-------[]----XXXXXX---------X-xxxxxxxxxxxxxxxxxxxxxxxxxxxxxxxxxx--
XXXXXXXXXXXXXXXXXXXXXXXXXXXXXXXXXX-------XX-XXXXXXXXXXXXXXXXX-XXXXXXXXXXXXXXXXXXXXXXXXXXXXXXXXXXXX--