----------------------------------------------------------------------------------------------------
----------------------------------------------------------------------------------------------------
------------------------------------------------------SSSSSS----------------------------------------
----------------------------------------------------------------------------------------------------
-----------------------------------------xxxx--------------------------------------xxxxx------------
---------xxxxx--------------------------xxXX-x----------------------------------E-xxXXX-x-----------
--------xx-<>-x------------------------xxXXX--x----------------------------------xxXXXX--x----------
-------xx--[]--x----------------------xxXXXX---x--------------------------------xxXXXXX---x---------
oo---xxx---[]---x--------------------xxXXXXX----x-----------------------------xxxXXXXXX----x--------
----xx<>--QQQ?---x------------------xxXXXXXX-----x------------xxxx-----------xx<>XXXXXX-----x-------
---xx-[]----------x-------xxxx-----xxXXXXXXX------x----------xxSS-x---------xx-[]XXXXXX------x------
--xx--[]-----------x-----xx<>-x---xxXXXXXXXX-------x-------Exx-SS--x-------xxXX[]XXXXXX-------xxx---
xxx---[]------E-----xxxxxx-[]--xxxxXXXXXXXXX--------xxxxxxxxx--SS---xxxxxxxxXXX[]XXXXXX-------XX-xxx
XXXXXXXXX-----X---XXXXXXXXXXXXXXXXXXXXXXXXXXXXXXXXXXXXXXXXXXX--XX--XXXXXXXXXXXXXXXXXXXXXXXXXXXXXXXXX