----------------------------------------------------------------------------------------------------
----------------------------------------------------------------------------------------------------
SSSSSSSSSSSSSSSSSSSSSSSSSSSSSSSSSSSSSSSSSSSSSSSSSSSSSSSSSSSSSSSSSSSSSSSSSSSSSSSSSSSSSSSSSSSSSSSSS---
XSSSSSS--------------------------x-----SSSSSSSSSSSSSSSSSSSSSSSSS------------X-----------------------
-SSSSSS------xxx-----------------------SSSSSSSSSSSSSSSSSSSSSSSSS-----------------------------------X
-SSSSSS-xxxxxx--x----------------------SSSSSSSSSSSSSSSSSSSSSSSSS----------------oo--------QQ------xx
-------xxSSSSS---xxxxx---------------------------------------------------------XX----------------xx-
------xx-SSSSS--SSSSS-x---------------------------xxxxx-------xxxxx--------------------xxx-xxx--xx--
xxxxxxx--SSSSS--SSSSS--xxxxxxxxxxxxxxxxxxxxxxxxxxxx----xxxxxxxxE---xx------------xxxxxxx--xx--xxx---
SSSSSSS--SSSSS--SSSSS?SS?SSSSS?????????SSSSSSSSSSS?----SSSSSSSSS--<>-x----------xxSSSSSS--QQ--QQQ---
SSSSSSS-----------------SSSSSSSSSSSSSSS---------------------------[]--x--------xx-SSSSSS------------
SSSSSSS-------<>--------SSSSSSSSSSSSSSQ-------------<>------------[]---x-xxx--xx--SSSSSS------------
SSSSSSS-------[]------------------------------------[]------------[]----xx--xxx---SSSSSS------------
XXXXXXXXXXXXXXXXXXXXXXXXXX-XX-XXXXXXXXXXXXXXXXXXXXXXXXXXXXXXXXXXXXXXXXXXXX--XXX---XXXXXXXXXXXXXXX---