----------------------------------------------------------------------------------------------------
----------------------------------------------------------------------------------------------------
---------------------------------------------------E------------------X-----------------------------
----------------------------------------------------------------------------------------------------
----------------------------------------------------------------------------------------------------
--S--------------------------------------------------------------------xxx--------------------------
EX--------------------------------------------------------------------xxX-x-------------------------
-X-------------------------------------------------------------------xxXX--x------------------------
-X---------X-EE----X--------------ooo-------------------------------xxXXX---x-----------E-----------
?X---------XSSSSSSSX--------------ooo------------------------------xxXXXX----x---------------X------
------------------------------------------------------------------xxXXXXX-----x------------xxxx-----
-------xxx-------------------------------------xxxxx-------------xxXXXXXX------S----oo----xx---x---x
xxxxxxxx--xxxxxxxxxxxxxxxxxxxxxxxxxxxxxxxxxxxxxxE-E-xxxxxxxxxxxxxxXXXXXXX------xxxxxxxxxxxx-----xxxx
XXXXXXXX--XXXXXXXXXXXXEEXEXXXXXXXXXXXXXEEXEXXXXXXXXXXXXXXXXXXXXXXXXXXXXXXXXXXXXXXXXXXXXXXXXXXXXXXXXX