----------------------------------------------------------------------------------------------------
----------------------------------------------------------------------------------------------------
-------------?--------------------------------------------------------------------------------------
----------------------------------------------------------------------------------------------------
--------------------------------------------------------------------------------------------------xx
--------------------xxxxx--------------------------------------Q---------------SSS---------------xx?
---------------SS--xx----x------------------QQQQ-------------------------------------------------x--
o-----------------xxX-----xxxx--------------------------------------------------------------xxxxxx--
-----------SS----xxXX------xB-xxxxx---------------------------xxxx-?-----------xxxx--------xx---xE--
x-xxx-----------xxXXX------XXXXEXX-xS-----------------Q------xx<>-x-----------xx--xxx-xxx-xx----<>--
-xxX-x--B------xxXXXX-----XXXXXXXX--x-----------------------xx-[]--x---------xx------xx--xx-----[]--
xx-X--x-b----xxxXXXXX----XXXXXXXXX---x---------------------xx--[]---x-------xx-------<>--<>-----[]--
x--X---xxxxxxx-XXXXXX---XXXXXXXXXX----xxxxxxxxxxxxxxxxxxxxxx---[]----xxxxxxxx--------[]--[]--E--[]--
XXXXXXXXXXXXXX-XXXXXXXXXXXXXXXXXXXXXXXXXXXXXXXXXXXXXXXXXXXXXXXXXXXXXXXXXXXXXX------XXXXXXXXXXXXXXXXX