----------------------------------------------------------------------------------------------------
-------------------------------------------------------------------------------------X--------------
SSSSSSSSSSSSSSSSSSSSSSSSSSSSSSSSSSSSSSS--------------------------------------------XXX?-------------
SSSSS-SSS----------------------------]--------------------------------------------------------------
SSSSSQSSS-------xxx------------------]--------------------------------------------------------------
SSSSSSSSS-xxxxxxx--x-----------------]------------------------------------------------------E-------
---------xxSSSSSS---xxxxx------------]----------------X--EX-----------------------------SSSS--S-----
---B----xx-SSSSSS--SSSSS-x----------------------------X---X-----------------------------------------
xxxxxxxxx--SSSSSS--SSSSS--xxxxxxx----------------X--X-X---X--------X-EE----X------------------------
SSSSSSSSS--SSSSSS--SSSSS?SS?SSSSS????SSSSSS-SSS--XSSX-XSS?X--------XSSSSSSSX---------------S--------
SSSSSSSSS------------------SSSSSSSSSSSSSS---SSS------------------------------------------------X----
SSSSSSSSS--------<>--------SSSSSSSSSSSSSS---SSS----------------xxx-----------------------E-xxxXX----
SSSSSSSSS--------[]----------------------B--SSSxxxxxxxxxxxxxxxxx--xxxxxxxxxxxxxxxxxxxxxxxxxx--xxxxxx
XXXXXXXXXXXXXXXXXXXXXXXXXXXXX-XX-XXXXXXXXXXXXXXXXXXXXXXXXXXXXXXX--XXXXXXXXXXXXEEXEXXXXXXXXXX--XXXXXX