----------------------------------------------------------------------------------------------------
----------------------------------------------------------------------------------------------------
----------------------------------------------------------------------------------------------------
---xxx------------------------------xxx-------------------------------------------------------------
--xx--x---E-----------------xx--xxxxx--x-----------------------------SSS------SSS---E---------------
-xxX---x--------------------x-xxx---X---x-----S----------QQ?QQX-----------------------------------xx
xx-X----x------------------xx--<>--------x----S---------------X----------------------------------xx-
xX-X-----x-----------------x---[]---------x-------------------X------X--------------------------xx--
XX-X------x--------------xxx---[]----------x--SSS-------XE-E--X------XEE----------------------xxx---
XX-X-------x------------xx<>---XX-----------x-SSS-------XQQ-QQX------XSSSSSS-----------------xx<>--Q
XX-X--------xxxx-------xx-[]-----------------xSSS-------------------------------------------xx-[]---
XX-X--------XXX-x-----xx--[]-------------------SSx------------EE----------------xxxx-------xx--[]---
XX-X--------X----xxxxxx---[]-----------------X-SS-xxxxxxxxxxxxxxxxxxxxxxxxxxxxxxx---xxxxxxxx---[]---
X--X--------X----XXXXXXXXXXXXXXXXXXXXX-------XXXXXXXXXXXXXXXXXXXXXXXXXXXXXXXXXXXX---XXXXXXXXXXXXXX--