----------------------------------------------------------------------------------------------------
----------------------------------------------------------------------------------------------------
----------------------------------------------------------------------------------------------------
--------------------------o----------------------------------xxx------------------------------------
---------------------------------------------------xxxx----xxx--x-------------------------------xxxx
xx----------------------SSS-------E---------------xx---x--xxXS---x---------------------------E-xxXXX
>-x------------------------------<>--------------xx-----xxxEX-----x---------------------------xxXXXX
]--x-----------------xxxxxxxxx---[]-------------xx-------xXXX------x-------------------------xxXXXXX
]---x--------------xxx---x----xx-XXX----------xxx--S-----XXXXS------x----------------------xxxXXXXXX
>----x-----SSS----xx<>---S---<>-x------------xx<>------XXXXXX--------x--------B-----------xx<>XXXXXX
------x----------xx-[]-------[]--x-xxxxxx---xx-[]-----XXXXXXX---------x-------b--?-B-----xx-[]XXXXXX
-------x--------xx--[]-------[]---xx<><>-x-xx--[]----XXXXXXXX----------x------B----b----xxSS[]XXXXXX
>------Xxxxxxxxxx---[]----E--[]----x[][]--xx---[]----XXXXXXXX---------X-xxxxxxxxxxxxxxxxx-SS[]XXXXXX
XXXXXXXXXXXXXXXXXXXXXXXXXXXXXXXXXXXXXXXXXXXXXXXXXXXXXXXXXXXXXXXXXXXXX-XXXXXXXXXXXXXXXXXXXXXXXXXXXXXX