----------------------------------------------------------------------------------------------------
----------------------------------------------------------------------------------------------------
----------------------------------------------------------------------------------------------------
----------------------------------------------------------------------------------------------------
------------------oooooooo---E--xxxxxxx---------E-------------------------------------xxxxxxxxxxx---
Q---------------SSSSSSSSSSSSSSSxx-SSSSxSSSSSSSSSSSSS---------------------------------xx--QQQ?QQQ-x--
------------------------------xx-------x--------------------------------------------xx------------x-
-----------------------------xx---------x------------------------------------------xx------E-------x
x--?-----------xxxxxxxxxxxxxxx-----------x------E-----X--------------------------xxx-----SSSSSSS----
oxx-----------xx--?SSSSSSSSSSX--X?--------x-----QQ?QQQX-------------------------xx<>--------------E-
<>-x---------xx----------------XX----------x-----------------------------------xx-[]-------X------X-
[]--x-------xx----------------XXX-----------xx--------------xxx--------x------xx--[]-------X------X-
-]---xxxxxxxx-----------E----XXXX-----------X-xxxxxxxxxxxxxxx-ExxxxxxxxXxxxxxxx---[]----E--X------X-
XXXXXXXXXXXXX---XXXXXXXXXXXXXXXXXXXXX-------XXXXXXXXXXXXXXXXX--XXXXXXXXXXXXXXXXXXXXXXXXXXXXXXXXXXXXX