--------------------------------------------------
--------------------------------------------------
--------------------------------------------------
------o--------------------------------------xx---
---------------------------------------xx---xx-xxx
----SSS-------E-----------------------xx-x-xx--SSS
-------------<>----------------------xx---xx------
-xxxxxxxxx---[]-------------xxxxxxxxxx----<>------
xx---x----xx-XXX----------xxx---x---<>----[]------
<>---S---<>-x------------xx<>---S---[]----XXX-----
[]-------[]--x-xxxxxx---xx-[]-------[]----------E-
[]-------[]---xx<><>-x-xx--[]-------[]---------<>-
[]----E--[]----x[][]--xx---[]-------[]---------[]-
XXXXXXXXXXXXXXXXXXXXXXXXXXXXXXXXXXXXXXXXXXXXXXXXXX