----------------------------------------------------------------------------------------------------
----------------------------------------------------------------------------------------------------
----------------------------------------------------------------------------------------------------
----------------------------------------------------------------------------------------------------
xxxxxx----------------------------------------------------------------------------------------------
SSSSS-x---------------------------------------------------------------------------------------------
X------x------------------------------?----------------------------------?--------------------------
S-------x-----------------------------E----------------------------------E--------------------------
---E-----x----xx----xx----XX-------------E----------------------------------E-----------------------
--<>------x--xx-x--xx-x-xxxx------------<>--------E--EE-------E------------<>--------E--EE----------
QS[]-------xxx---xxx---xx---x-----------[]-------<>--<>------<>------------[]-------<>--<>---------E
SS[]---<>---x-----x----<>----x---B------[]---<>--[]--[]-------------B------[]---<>--[]--[]----------
SS[]---[]--<>----<>----[]--------b------[]---[]--[]--[]-------------b------[]---[]--[]--[]----------
XXXXX--[]--[]----[]----[]-----xxxxxxxxxx[]---[]--[]--[]-------xxxxxxxxxxxxx[]---[]--[]--[]----------