----------------------------------------------------------------------------------------------------
----------------------------------------------------------------------------------------------------
-------------------------------------------------XXX------------------------------------------------
-------------------------------------------------[]----------xxxxx----------------------------------
-------------------------------------------------[]--------xxx----x-----------------xxxxxxx---------
XXXXXXXXXXX-------------X------------------------<>-------xx<>-----x---------------xx-SSSS-x--------
[]------[]-----------------------------------------------xxX[]------x-------------xx--------x-------
[]------[]------------X---------------------------------xxXX[]-------x-----------xx----------x------
[]------[]------xxx----------------------------------xxxxEXX[]--------x--xxx---xxxX-----------x-----
[]------[]-----xx<-x----------------------------xxxxxx<><>XX[]---------xxxS-x-xxXEX---S-----X--x----
<>------<>----xx-[]-x--------------------------xxX]XXX[][]XX[]----------x----xxXXXX---------X---x---
xxx-----xxx--xx--[]--x---------xx------------Exx-X]XXX[][]XX[]----------SS-SSxXXXXX---------XX---x--
xE-xxxxxxE-xxx---[]---xxxxxxxxxxXxxxxxxxxxxxxxx--X]XXX[][]XX[]--------X-SS-SSXXXXXX----EE---XX---Exx
XX-XXXXXXX-XXXX--XXXXXXXXXXXXXXXXXXXXXXXXXXXXXX--XXXXXXXXXXXXXXXXXXXXXXXXXXX-XXXXXXXXXXXXXXXXXXXXXXX