----------------------------------------------------------------------------------------------------
----------------------------------------------------------------------------------------------------
----------------------------------------------------------------------------------------------------
----------------------------------------------------------------------------------------------------
----------------------------------------------------------------------------------------------------
--SSSS------------------------------E--S---SSSSSSSSS------------SS---SS-------------SSS-----E-------
-------------------x---------------<>------------------------------------------------------<>-------
------------------xx---------------[]------------------------------------------------------[]------x
--xxxx----------xxx--xxx-----------[]------------xxxx---------SS--------------xxxxx--------[]----xxx
-xx<>-x--------xx<>-xx--x-xxx-----SXXS----------xx--xxx-xxx---------SSS---xxxxx-XX-xSSS----XXX--xx<>
xx-[]--x------xx-[]-x----xx--xxx------xxxx-----xx------xx--xxx-----------xxXX<>-XX--x----------xx-[]
x--[]---x----xx--[]------<>--<>-x----xx<>-x---xx-------<>--<>-x-xxxxx---xxXXX[]-XXX--x--------xx--[]
E--[]----xxxxx---[]------[]--[]--xxxxx-[]--xxxx--------[]--[]--xx----xxxxXXXX[]-XXX---xxxxxxxxx---[]
XXXXXXXXXXXXXXXXXXXX---XXXXXXXXXXXXXXXXXXXXXXXX------XXXXXXXXXXXX-X-XXXXXXXX-XXXXXXXXXXXXXXXXXXXXXXX