----------------------------------------------------------------------------------------------------
----------------------------------------------------------------------------------------------------
--------E-SS----------------------------------------------------------------------------------------
----------------------------------------------------------------------------------------------------
-------------------------------xxxxxxxxxxx----------E-E------------------xxxx-----------------------
-----SSS?S--------------------xx--QQQ?QQQ-x-------SSSSSSS-SS-xxxx-------xx---x-------xx-------------
-----------------------------xx------------x-------------E--xx---x-----xx-----x-----xx-x------------
----------------------------xx------E-------x--------------xx-----x-xxxx-------x---xx---xxx---------
--------------------------xxx-----SSSSSSS----x-----------xxx-------xx-<>--------xxxx----<>-x---Q--Q-
---X-------S-xxx---------xx<>--------------E--x---------xx<>-------<>-[]---S--XSSSS?----[]--x-------
--XX--------xxX-x-------xx-[]-------X------X---x---E---xx-[]-------[]-[]----------------[]---x------
QXXX------Exx-X--x-----xx--[]-------X------X----x-----xx--[]-------[]-[]-----------S----[]----x-----
xxxxxxxxxxxx--X---xxxxxx---[]----E--X------X-----xxxxxx---[]-------[]-[]----------------[]-----xxxxx
XXXXXXXXXXXX--XXXXXXXXXXXXXXXXXXXXXXXXXXXXXXXXXXXXXXXXXXXXXX-------XX-XXXXXXXXXXXXXXX---XXXX-XXXXXXX