--------------------------------------------------
---------------------xxx--------------------------
--------------------xx--x-------------------------
-------------------xx----xx-----------------------
------------------xx-----E-xxxxxx-----------------
-------S--------xxx---------x----x-------SSSSSSSS-
---------------xx-S--------<>-----x---------------
--------------xx-----------[]------xxxx---------xx
-xxxx--------xx------------[]-------xB-xxxxxxxxxx-
xx<>-x------xx-------X-----XX-------XXXXESSSSSSSS-
--[]--x----xxE---------------------XXXXXX---------
x-[]---x--xx<>--------------------XXXXXXX---------
--[]----xxx-[]-----X-------------XXXXXXXX---------
XXXXXXXXXXXXXXXXXXXX-------------XXXXXXXXXXXXXXXXX