----------------------------------------------------------------------------------------------------
----------------------------------------------------------------------------------------------------
----------------------------------------------------------------------------------------------E-----
---------------------------------------------------------------------------------------------<>-----
-----------------xxx--------oo---------------------------------------------------------------[]-----
----------------xx--x------------------------------------------------------------------------[]-----
---------------xx----x------------------------------------E-----ES--------------E-------------]-----
--------------xx------x-----------------------------------------------QQ-------<>-------------------
x-------o---xxx--o-----xxx----------------------------------------------Q------[]-------------------
-xxx-------xx<>--------<>-x------------------------------xxxx---------------QQQQQQQQQQ--------------
E<>-x-----xx-[]--------[]--x-----xxxx-------------------xx<>-x-------------------------------------x
S[]--x---xx--[]--------[]---x---xx<>-x-----------------xx-[]--x---------xxxxx---------------------xx
>[]---xxxx---[]--------[]-E-Exxxx-[]-Exxxxxxxxxxxxxxxxxx--[]---xxxxxxxxxxB---xxxxxxxxxxxxxxxxxxxxxx-
XXXXXXXXXXXXXXXXXXXXXXXXXXXXXXXXXXXXXXXXXXXXXXXXXXXXXXXXXXXXXXXXXXXXXXXXXX--XXXXXEEXXXXXXXXXXXXXXXXX