----------------------------------------------------------------------------------------------------
----------------------------------------------------------------------------------------------------
-----------------------------------------------------------------------------------------xx---------
----------------------------------------------------------------------------------------xx-x--------
---------------------------------------------------------------------------------------xx---x-------
E-------------------------SSSSSSS--------------------------------xxx---------------xxxxx-----x------
>---------------------------------------------------------------xxX-x-------------xxXSSS------x-----
]--------------------------------------------------------------xxXX--x-----------xxXXX---------x----
]----xxxx------------------E--E---------------xx--------------xxXXX---x---------xxXXXS----------x---
]---xx<>-x----------------SSSSSSS------xxxx--xx-x------------xxXXXX----x-------xxXXXXX-----------xxx
---xx-[]--x----QQQQQQ-?---------------xx---xxx---x----------xxXXXXX-----x-----xx-XXXXX-SSS-------<>-
x-xx--[]---x-----------------xxx-----xx-----x--------------xxXXXXXX------x---xx--XXXXX-----------[]-
-xx---[]----xxxxxxxxxxxxxxxxxx--xxxxxxX-----X----XxxxxxxxxxxXXXXXXX-------xxxx--XXXXXX-----------[]-
XXXXXXXXXXXXXXXXXXXXXXXXXXXXXX--XXXXXXX-----X----XXXXXXXXXXXXXXXXXXXXXXXXXXXXXXXXXXXXXXX---XXXXXXXXX