----------------------------------------------------------------------------------------------------
----------------------------------------------------------------------------------------------------
x---------------------------------------------------------------------------------------------------
-x---------------------------------------------x----------------------------------------------------
-----------------------------------------------xxxxxxxxxxxx----------------------------xxx----------
----------------------------------SSSSS--------xx--QQQ?QQQ-x-------SSSQ---?-------xxx--xQ-x---------
---------------------------------------xxxx---xx------------x--------------------xx--x-x---x--------
--------------------------------------xx---x-xxS-----E-------x------------------xx----xx----x-------
-----------------------xxx----------xxxS----xx-----SSSSSSS----x----------------xx------x-----x------
--------xxxx----------xx--x-------xxxSS-----<>--------------E--x------S------xxx-------SS-----xxx---
xxx----xx---xxxxx----xx----x-----xx<>-------[]-------X------X---x-------E---xx<>--------------<>-x--
-X-x--xx----XXXX-x--xx------xxx-xx-[]-------[]-------X------X----x---------xx-[]--------------[]--x-
XX--xxx-----------xxx-------XX-xx--[]-------[]----E--X------X-----xxxxxxxxxx--[]-E------------[]---x
X---XXX-----------XXX-------XXXXXXXXXXXXXXXXXXXXXXXXXXXXXXXXXXXXXXXXXXXXXXXXXXXXXXXXXXXXXXXXXXXXXXXX