------------------------------------------------------xx--------------------------------------------
-------------------------------xxxxxxxxxxxxxxxxxxxxxxxX-x-------------------------------------------
-------------------------------xXXXXXXXXXXXXXXXXXXXXXXX--x---SSSSSSSSSSSSSSSSSSSSSSSSSSSSSSSSSSSSSSS
------------------------------xxXXXXXXXXXXXXXXXXXXXXXXX---x--SSSSSSS--SSSSSSS<>-SSSSSSSSS--SSSSSSS--
-----------------------------xx-XXXXXXXXXXXXXXXXXXXXXXX----x-SSSSSSS--SSSSSSS[]-SSSSSSSSS--SSSSSSSE-
-----------------------------xS-XXXXXXXXXXXXXXXXXXXXXXX-----xSSSSSSS--SSSSSSSSS-SSSSSSSSS--SSSSSSSSS
-----------------------------x--XXXXXXXXXXXXXXXXXXXXXXX------x------------------SS-----------S----SS
----------------------------xx--XXXXXXXXXXXXXXXXXXXXXXX-------x-----------------SS-----------S----SS
---X-E---------------------xxS--XXXXXXXXXXXXXXXXXXXXXXX-------oxxx-----oooo-----SSo??--------So??-SS
---XSSSSSX-----------------x----XXXXXXXXXXXXXXXXXXXXXXX------S?SS-x----SSS------SSSS---------SSS--SS
---------X----------------xx----XXXXXXXXXXXXXXXXXXXXXXX------SSS---x--------------------------------
x--S-SSSSX---------------xx---E-XXXXXXXXXXXXXXXXXXXXXXX------SS-----x----------------xxx------------
-xxxxxxxxxxxxxxxxxxxxxxxxx------XXXXXXXXXXXXXXXXXXXXXXX--------E-EE--xxxxxxxxxxxxxxxxx--xxxxxxxxxxxx
XXXXXXXXXXXXXXXXXXXXXXXXXXXXXXXXXXXXXXXXXXXXXXXXXXXXXXX----XXXX-XXXXXXXXXXXXXXXXXXXXXX--XXXXXXXXXXXX