----------------------------------------------------------------------------------------------------
x---------------------------------------------------------------------------------------------------
-x------------SSSSSSSSSSSSSSS--<SSSSSSXSSSS--------------------------------S------------------------
--x-------------[]----[]--[----[SSSSSSSSSSS-------------------XXXXXXXXXXX--S------------------------
---x------------[]----[]--[----[SSSSSSSSSSS------------------XX------------S-----------------------E
----x-----------[]----[]--[----[SSSSSSSSSSS-----------------XXX------------S-------------------QQQQQ
-----x----------<>----[]--[----[SSSSSSSSSSS----------------XXXX------------S------------------------
------x---------------[]-------]SSSSSSSSSSS---------------XXXXX------------S------------------------
-------x--------------[]-------]SSSSSSSSSSS--------------XXXXXX------------S---o--E----xxxx---------
--------x-------------[]-xxxxxx]SSSSSSSSSSS--------E----XXXXXXX------------S---S------xx<>-x--E?QQQQ
-E-------x------------<>xxSSSSSSSSSSSSSSSSS---E---<>---XXXXXXXX-----<>-----S---------xx-[]--x-------
<>--------x----xxx-----xx-SSSSSSSSSSSSSSSSS--<>---[]--XXXXXXXXX-----[]-----S--------xx--[]---x------
[]-------X-xxxxx--xxxxxx--SSSSSSSSSSSSSSSSS--[]---[]-XXXXXXXXXX-----[]-----Sxxxxxxxxx---[]----xxxxxx
XXXXXXXXXXXXXXXX--XXXXXXEEXXXXXXXXXXXXXXXXX--XX---XXXXXXXXXXXXXXXXXXXXXXXXXXxXXXXXXXXXXXXXXXXXXXXXXX