--------------------------------------------------
--------------------------------------------------
XX------------------------------------------------
-------xxxxx---------------------------------o----
----xxxx----x-----------xxx-----------------------
---xx-<>-----x---------xx--x---------------SSS----
--xx--[]------x-------xx----x-----xxxx------------
--x---[]-------------xx------x---xx---x-xxxxxxxxx-
xxx---[]-------xxxxxxx--------x-xx-----xx---x----x
x<>---[]-------SSSSSSS--S------xx------<>---S---<>
-[]---[]-------SSSSSSS---------<>------[]-------[]
-[]---[]-------SSSSSSS---<>----[]------[]-------[]
-[]---[]-------SSSSSSS---[]----[]------[]----E--[]
XXX---XXXXXXXXXXXXXXXXXXXXXXXXXXXXXXXXXXXXXXXXXXXX