----------------------------------------------------------------------------------------------------
x---------------------------------------------------------------------------------------------------
-x--------------------------------------------------------------------------------------------------
<]xx------------------------------------------------------------------------------------------------
[]----------------------------------------------xxxx----------S-------------------------------------
[]--------------xxxxx--------------------------xxXX-x---------SSSSSS----------xxxxx-----------------
[]-------------xx-<>-x------------------------xxXXX--x-----------------------xx-<>-x---------------x
[]------------xx--[]--x----------------------xxXXXX---x---------------------xx--[]--x-------------xx
------------xxx---[]---x--------------------xxXXXXX----x------------------xxx---[]---x-----------xx-
-E---------xx<>--QQQ?---x------------------xxXXXXXX-----x----------------xx<>--QQQ?---x---------xx--
->SS------xx-[]----------x-------xxxx-----xxXXXXXXX------x--------------xx-[]----------x-------xxE--
-]SSx----xx--[]-----------x-----xx<>-x---xxXXXXXXXX-------x------xxx---xx--[]-----------x-----xx<>--
<]SSXxxxxx---[]------E-----xxxxxx-[]--xxxxXXXXXXXXX--------xxxxxxx--xxxx---[]------E-----xxxxxx-[]--
XXXXXXXXXXXXXXXX-----X---XXXXXXXXXXXXXXXXXXXXXXXXXXXXXXXXXXXXXXXXX--XXXXXXXXXX-----X---XXXXXXXXXXXXX