-------xxxxxx------------xxxxxx---xxxxx-------------------------------------------------------------
--------x----x-------xxxxx----xxxxx-----------------------------------------------------------------
--------------x-----xx--x-------SSS--------------------------XX-----------------------S-------------
---------------x---xx---X-------------------------------------------------------------S-------------
----------------x-xx------------------------------------------------------------------S-------------
-----------------xx-------------------------------------------------------------------S----SSQQS----
-----------------XX----------X-------------------S------------------------------------S-------------
--------------------------------------------------------------------------------------S-------------
---------------------------------------------------S----------------------------------S-------------
-----------------------------------------------E----?S-------------E-----?QQQQQ?------S------SS----x
QQQ---QQQQ?------------------------------<>---<>------------------<>------------------S-----------xx
----------x-------------X-------oooooo---[]---[]-----------<>-----[]-----B------------S----------xxX
xE---------xx-------------------oooooo---[]---[]------E----[]-----[]-----b-E---B------SxxxxxxxxxxxXX
XxxxxxxxXXXXX-------------------XXXXXX---[]---[]XXXXXXXXXX-XXXXXXXXXXXXXXXXXXXXXXXX-XXXxXXXXXXXXXXXX