--------------------------------------------------
-------------------------xxx----xx----------------
------------------------xx--x--xx-x---------------
-----------------------xx----xxx---x--------------
xx----?--------xxxx---xx------x-----x-------E-----
--x--S??------xx---x-xx-------E------x----SSSSSSSS
---x---------xx-----xx-------<>-------x-----------
----x--xxxxxxx------<>-------[]--------x----------
-----xxx----<>------[]-------[]--------oxxxxxxxxxx
---XXSSS----[]------XXS------XXX------S?SSSSSSSSSS
------------[]------------------------SSS---------
]-----------[]-------------------<>---SS----------
]-----------[]-------------------[]-----E---------
XXXXXXXXX---XXXXXXXXXXXXXXXXXXXXXXXXXXXX-XXXXXXXXX