----------------------------------------------------------------------------------------------------
------------------------xxxxxxxxxxxxxxxxxxxxxxxxxxxxxxxxxxxxxxxxxxxxxx--------------xxxxxxxxxxxxxxxx
SSSSSSSSSSSSSSS--------xxSSSSSSSSSSSSSSSSSSSSSSSSSSSSSSSSSSSSSSSSSSSS-x-----SSSS---xxSSSSSSSSSSSSSSS
SSSSSS----------------xx-----------------------------------------------x----------xx----------------
SSSSSS-----------XXX-xx-----XXXX----------------------------------------x----?---xx-----------------
SSSSSS--QQ------xxxxxxSSS------------E-----------------------------------x--S??-xx------------------
---------------xx---xx--------------<>------------------------------------x----xxXXX----------------
-E---xxx-xxx--xx-----xS-------------[]-------------------------------------x--xx--------------------
xxxxxx--xx--xxx------S-S------------[]-------S-------------------E----------xxx---------------------
SSSSSS--QQ--QQQ---------S------E--SS[]SS---E---E----------------<>------XXX-SSSS----------------E--<
SSSSSS------------------------<>----[]----<>--<>-------------XX-[]--XXX------------------E-----<>--[
SSSSSS------------------------[]----[]----[]--[]------------XXX-[]--XXX-----------------<>-----[]--[
SSSSSS------------------------[]-E--[]----[]--[]--------E-E-XXX-[]--XXX-----------------[]---E-[]--[
XXXXXXXXXXXXXXX------XXXXXXXXXXXXXXXXXXXXXXXXXXXXXXXXXXXXXXXXX--XX--XX------XXXX------XXXXXXXXXXXXXX