----------------------------------------------------------------------------------------------------
----------------------------------------------------------------------------------------------------
--------------------------------------SSSSSSSSSSSSSSSSSSSSSSSSSSSSSSSSSSSSSSSSSSSSSSSS--------------
----------------------------------------------------------------------------------------------------
----------------------------------------------------------------------------------------------------
----------QQQQ-----------SSSS--------SSSSSS--------------------------------------------xx---xxxx----
-----------------------------------------------------------------------<>-------------xx-xxxx---x---
------------------------------------------------------xxxx---------------------------xx-EXXXX----x--
--xxxx-----------------------xxxx-------------------xxx-<>xxxxx------------------xxxxx------------xx
-xx<>-x--E?QQQ----------S---xx<>-x-QQQQQ--QQQ-----xxx-?-[]SSSS-x----------------xx-XXX------------XX
xx-[]--x-------------------xx-[]--x--------------xx<>---[]------x--------------xx-------------------
x--[]---x-----------------xx--[]---x------------xx-[]---[]-------x----xxx-----xx--------------------
E--[]----xxxxxxxxxxxxxxxxxx---[]----xxxxxxxxxxxxx--[]---[]--------xxxxx--xxxxxx---------------oooo--
XXXXXXXXXXXXXXXXXXXXXXXXXXXXXXXXXXXXXXXXXXXXXXXXXXXXXXXXXXXXXXXX-XXXXXX--XXXXXX---------------XXXX--