----------------------------------------------------------------------------------------------------
----------------------------------------------------------------------------------------------------
----------------------------------------------------------------------------------------------------
----------------------------------------------------------------------------------------------------
----------------------------------------------------------------------------------------------------
----SSSSSSSSS-------------SS----SS----------------------------------------------------------------xx
-------------------------------------------------------------------------------------------------xxX
--------------------------------------------------o---------------------------------------------xxXX
----------xxxx----------SS---------------xxxxx-----------------------------xx------------------xxXXX
x--------xx--xxxx-xxx----------SSS---xxxxx-XX-xSSS------------------xxxx--xx-x----------------xxXXXX
-xx-----xx-------xx--xxx------------xxXX<>-XX--x-------------E-----xx---xxx---x--------------xxXXXXX
<>-x---xx--------<>--<>-x-xxxxxx---xxXXX[]-XXX--x-----------------xx-----x-----xx-----------xxXXXXXX
[]--xxxx---------[]--[]--xx-----xxxxXXXX[]-XXX---xxxxxxxxxxxxxxxxxxX-----X-----X-xxxxxxxxxxxxXXXXXXX
XXXXXXXX-------XXXXXXXXXXXX-X--XXXXXXXX-XXXXXXXXXXXXXXXXXXXXXXXXXXXX-----X-----XXXXXXXXXXXXXXXXXXXXX