----------------------------------------------------------------------------------------------------
----------------------------------------------------------------------------------------------------
----------------------------------------------------------------------------------------------------
----------------------------------------------------------------------------------------------------
----------------------E---------------------E-------------------------------------------------------
X-----------------SSSSSS----S---------------S--------------xxx---XX-------------------------E-------
[]--------------------------------------------------------xx--xx---------------------------SSSS-----
[]------------------------------------------?------------xx---X-x-----------------------------------
[]-----------------E------------------------------------xx-E--X--x----------xxxxx------X-E--E-------
[]--------xxxxx---SSSSSS---xxxx------------xxx---------xx--X--X---x--------xxS-x-xx----XS?SSSSS---X-
[]-------xx-<>-x----------xx<>-x----------xxX-x-------xxE--X--X----x---xxxxx---E---x-----------EE-X-
<>--B---xx--]]--x--------xx-[]--x------B-xx-X--x-----xx-X--X--X-----x-xx---SS-SS-S--x--SSSSSSSSSSSX-
xxxxxxxxx---]]---xxxxxxxxx--[]---xxxxxxxxx--X---xxxxxx--X--X--X------xxX---SS-SS-S---xxxxxxxxxxxxxxx
XXXXXXXXX--XXXXXXXXXXXXXXXXXXXXXXXXXXXXXXXXXXX-XXXXXXX--X--X--X-----XXXXXXXXXXXXXXXXXXXXXXXXXXXXXXXX