----------------------------------------------------------------------------------------------------
----------------------------------------------------------------------------------------------------
-----------------------------------------------------------------------oo---------------------------
------------------------------------------------------------------------------------xxx-----xxx-----
------------------------------------xxxxx----------------------------------------xxxx-oxoooxx--x--oo
E--------------------------------E-xxXXX-x-----------------------------XXX------xx-XX---x-xx----x---
>-------------xxxxx---------------xxXXXX--x------------------------------------xx--------xx------x--
]------------xx?---x-------------xxXXXXX---x----------------------------------xx---------XX-------x-
XX---------xxx------xx---------xxxXXXXXX----x----------------------------xxxxxx--------------------x
----------xx<>-----<>-x-------xx<>XXXXXX-----x------------------XXXX----xxXXXXX--------------------X
--xxxx---xx-[]-----[]--x-----xx-[]XXXXXX------x------------------------xx---------------------------
Xxx<>-x-xx--[]-----[]---x---xx-X[]XXXXXX-------xxx--------xxx---xxx---xx--------------------XXX-----
xx-[]--xx---[]-----[]----xxxx-XX[]XXXXXX-------XX-xxxxxxxxx--xxxx--xxxx-----------------------------
XXXXXXXXXXXXXXXXX--XXXXXXXXXXXXXXXXXXXXXXXXXXXXXXXXXXXXXXXX--XXXX--XXXX---------XXXX--XXXX----------