----------------------------------------------------------------------------------------------------
----------------------------------------------------------------------------------------------------
SSSSSSSSSSSSSSSSSSSSSSSSSSSSSSSSSSSSSSSSSSSSSSSSSSSSSSSSSSSSSSSSSSS?SSSSSSSSSSSSSSSSSSSSSSSSSSSSSSSS
SSSSSS------------------SSS--SSSSSS--S------SSSS------SSSS------------------------------------------
SSSSSS---E--------------SSS--SSSSSS--S------SSSS--E---SSSS------------------------------------------
SSSSSS---ooo-oo--------SS--------SS---x------S----SS----------oooooo--------------------------------
-----------------------SS--------SS----xx----S----SS--------------------------------xx--------------
-------S-SSS-SS-S------SS--------SS---S------S----SS----------SSSSSS---------------xx-x-xxx---------
x------SoSS--SSoS------SS----ooooSS---So?----So??-SS---E------SSSSSS--------------xx---xx--x--------
-xx----SSSS--SSSS------SSSS--SSSSSS---SSS----SSS--SS--SSSS----------------------xxx----<>---x------x
---xx--------------------SS--------------------------EE------------------------xx<>----[]----xxx--xx
--<>-x-------------------SS------------------------------xxxxx----------------xx-[]----[]----<>-xxx-
>-[]--xxxxxxxxxxxxxxxxxxxxxxxxxxxxxxxxxxxxxxxxxxxxxxxxxxxx----xxxxxxxxxxxxxxxxx--[]----[]--E-[]--x--
X-XXXXXXXXXXXXXXXXXXXXXXXXXXXXXXXXXXXXXXXXXXXXXXXXXXXXXXXX---XXXXXXXXXXXXXXXXXXXXXXXXXXXXXXXXXXXXX--