----------------------------------------------------------------------------------------------------
----------------------------------------------------------------------------------------------------
----------------------------------------------------------------------------------------------------
----------------------------------------------------------------------------------------------------
-------------------------------------------------------xxxxxx---------------------------------------
--SSS--------SSSSS-----SSSSS--------------------------xx?SSS-x-------------------------------------x
------------------------------------------------------x-------x-----------------------------------xx
-------------------------------------------------xxxxxx-------Ex---------------------------------xx-
-----xxxx-------------------------xxxx----------xx---xE------<>-x----------------------------xxxxx--
----xx<>-x-QQQQ--QQQ-------------xx<>-x--------xx----<>---E--[]--x--------------------------xx--XX--
---xx-[]--x---------------------xx-[]--x-----xxx-----[]--<>--[]---x--------------------E---xx---XXX-
x-xx--[]---x----------xxxxxx---xx--[]-------xx<>-----[]--[]--[]----x-xxxxx--------E-------xx----XXXX
-xx---[]----xxxxxxxxxxx-----xxxxE--[]---xxxxx-[]--E--[]--[]--[]-----xx----xxxxxxxxxxxxxxxxxX----XXXX
XXXXXXXXXXXXXXXXXXXXXXX-----XXXXXXXXXX---XXXXXXXXXXXXXXXXXXXXXXXXXXXXX---XXXXXXXXXXXXXXXXXXX----XXXX