----------------------------------------------------------------------------------------------------
-----------------------------------------xxxxxxxxxxxxxxxxxxxxxxxxxxxxxxxxxxxxxxxxxxxxxxxxx----------
SSSSSSSSSSSSSSSSSSSSSSSSSSSSSSSS--------xxSSSSSSSSSSSSSSSSSSSSSSSSSSSSSSSSSSSSSSSSSSSSSSSS----------
----SSSSSSSSSSSSSSSSSSS----------------xx-----------------------------------------------------------
----SSSSSSSSSSSSSSSSSSS-----------XXX-xx------------------------------------------------------------
----SSSSSSSSSSSSSSSSSSS--QQ------xxxx-xSSS------------E------------------------E----E---------------
--------------------------------xx---xx--------------<>-----------------------<>---<>---------------
-----------xxx--------xxx-xxx--xx-----xS-------------[]-----------------------[]---[]---------------
----xxxxxxxx?-xxxxxxxxx--xx--xxx------S-SS-----------[]-------S---------------[]---[]---------------
---xx-?SSSSS??SSSSSSSSS--QQ--QQQ---------S------E--SS[]SS--------E---------E--SSS--[]---------------
--xx--SSSSS---SSSSSSSSS------------------------<>----[]----<>---<>--------<>-------[]---SS----------
xxx---SSSSS---SSSSSSSSS------------------------[]----[]----[]---[]--------[]-------[]---SS----------
-x---------oooSSSSSSSSS------------------------[]-E--[]----[]---[]--------]]-E-----[]---SSxxxxxxxxxx
XX---XXXXXXXXXXXXXXXXXXXXXXXXXXX------XXXXXXXXXXXXXXXXXXXXXXXXXXXXXXXXXXXXXXXXXXXXXXXX--XXXXXXXXXXXX