----------------------------------------------------------------------------------------------------
----------------------------------------------------------------------------------------------------
------------------------------------------------------------------------------------------?---------
----------------------------------------------------------------------------------------------------
------------------xxxxxxx------------------------E--------------------------------------------------
-----------------xx-SSSS-x-------------------QQQQQQQQQQ-------------SSSSS------------------------xxx
----------------xx--------x-----------------------------------------------------------------SS--xx--
---------------xx----------x--------------------<>---------------------------------------------xxX--
--------------xxX-----------x--------xxxx-------[]-E-----------------E------------------SS----xxXX--
-------S?S---xxEX---S-----X--x------xx<>-x--E?QQQQQQQQQ------------SSSSSS-xxx----------------xxXXX--
x-----------xxXXX---------X---x----xx-[]--x------------------xxxx--------xxX-x--B--?-B------xxXXXX--
-x---------xxXXXX---------XX---x--xx--[]---x----------------xx<>-x------xx-X--x-b----b----xxxXXXXX--
X-xxxxxxxxxxXXXXX----EE---XX---Exxx---[]----xxxxxxxxxxxxxxxxx-[]--xxxxxxx--X---xxxxxxxxxxxx-XXXXXX--
XXXXXXXXXXXXXXXXXXXXXXXXXXXXXXXXXXXXXXXXXXXXXXXXXXXXXXXXXXXXXXXXX-XXXXXXXXXXXXXXXXXXXXXXXXX-XXXXXXXX