----------------------------------------------------------------------------------------------------
----------------------------------------------------------------------------------------------------
----------------------------------------------------------------------------------------------------
----------------------------------------------------------------------------------------------------
-------xxxxxxxxxxx---------------------------------------xxxxxxxxxxxx--------------------xxxxxxxxxx-
------xx--QQQ?QQQ-x-------SSSQ------------S-------------xx--QQQ?QQQQ-x---------------S--xx-QQQ?QQQ-x
-----xx------------x----------------------------xxxx---xx-------------x----------------xx-----------
----xx------E-------x--------------------------xx---x-xx------E---S----x--------------xx------E-----
--xxx-----SSSSSSS----x-------------------xxxx-xx-----xx-----SSSSSS-S----x-----------xxx----SSSSSSS--
-xx<>--------------E--x------S----------xx<>-xx------<>------------------x---------xx<>-------------
xx-[]-------X------X---x---------------xx-[]-<>------[]-------X---S-------x-------xx-[]-------------
x--[]-------X------X----x-------------xx--[]-[]------[]-------X---S--------x-----xx--[]-------X-----
---[]----E--X------X-----xxxxxxxxxxxxxx---[]-[]-E----[]----E--X-----------X-xxxxxx---[]-------------
XXXXXXXXXXXXXXXXXXXXXXXXXXXXXXXXXXXXXXXXXXXXXXXXXXXXXXXXXXXXXXXXXXXX--XXXXXXXXXXXXXXXXXXXXXXXXXXXX--