----------------------------------------------------------------------------------------------------
---------------------------------------------------E------------------------------------------------
-E--SSSSSSSSSSSSSSSSSSSSSSSSSSSSSSSSSSSSSSSSSSSSSSSSSSSSSSSSSSSSSSSSSSSSSSSSSSSSSSSSSSSS?SSSSSSSSSSS
----------------------SSSSSSSSSSSSSSSSSSSSSSSSSSSSSSSSS---SSSSSSSSSSS----------[]---------------SS--
----------------------SSSSSSSSSSSSSSSSSSSSSSSSSSSSSSSSS?--SSSSSSSSSSS----------[]---------------SS--
----------------------SSSSSSSSSSSSSSSSSSSSSSSSSSSSSSSSS?--SSSSSSSSSSS----------[]-----ooo-----SS----
-------------------------------------------------------------------------------<>-------------SS----
-----------------------------xxx----------------------------------------------------S-SSS-----SS----
----------------------xxxxxxxx?-xxxxxxxxxxxxxxxxxxxxxxxxxxxxxxxxxxxxxx--------------SoSSS-----SS----
---------------------xx-SSSSSS??SSSSSSSSSSS?SS????????????SSSSSSSSS<>-x-------------SSS-------SSSS--
--------------------xx--SSSSS---SSSSSSSSSSSSSSSSSSSSSSSSSS----------]--x------------------------SS--
xx----x------xxxx--xx---SSSSS---SSSSSSSSSSSSSSSSSSSSSSSSSS----------]---x-----xxx---------------SS--
E-xxxx-xxxxxxx---xxx---------oooSSSSSSSSSSSSSSSSSSSSSSSSSS----------]-E--xxxxxx--xxxxxxxxxxxxxxxxxxx
XXXXXXXXXXXXXX---XXX---XXXXXXXXXXXXXXXXXXXXXXXXXXXXXXXXXXXXXXXXXXXXXXXXXXXXXXXX--XXXXXXXXXXXXXXXXXXX