----------------------------------------------------------------------------------------------------
----------------------------------------------------------------------------------------------------
----------------------------------------SSSSSSSSSSSSSSSSSSSSSSSSSSSSSSSS-xx-------------------------
------------------------------------------------------------------------xx-x------------------------
-----------------------xxxxx-------------------------------------------xx---x----------xxxxx--------
----------------------xxXX--x------------------------------------xxxxxxx-----x--------xxXX--x-------
---------------------xxXXX---x----------------------------------xxSSSSSS------x------xxXXX---x------
--------------------xxXXXX----x--------------------------------xx-SSSS---------x----xxXXXX----x-----
-------------------xxXXXXX-----x---------------------------xxxxx--SSS-----------x--xxXXXXX-----x----
----SSQS--------xxxxXXXXXX------x-----------QQQQQQ--Q----xxxXXXX-----------------xxxXXXXXX------x---
xxx-----------xxx--XXXXXXX-------x----------------------xxXXXXXXXX----S-SS--------xXXXXXXX-------x--
<>-x---------xx<>-XXXXXXXX--------xx-------------------xxXXXXXXXXX---------------XXXXXXXXX--------xx
[]--xxxxxxxxxx-[]XXXXXXXXX--------X-xxxxxxxxxxxxxxxxxxxxXXXXXXXXXXE-------------XXXXXXXXXX--------X-
XXXXXXXXXXXXXXXXXXXXXXXXXXXXXXXXXXXXXXXXXXXXXXXXXX<>XXXXXXXXXXXXXXXXXXXX---XXXXXXXXXXXXXXXXXXXXXXXXX