--------------------------------------------------
--------------------------------------------------
--------------------------------------------------
--------------------------------------------------
-----------------------------oo-------------------
--------------------------------------------------
--------------------------------------------------
--------------------------------------------------
-----------------------xxxx-----------------------
------S--------E------xx<>-x----------------------
xx------------<>-----xx-[]--x-----xxxx------------
X-x-----------[-----xx--[]---x---xx<>-x--------xxx
X--xxxxxxxxxxxxxxxxxx---[]-E-Exxxx-[]-Exxxxxxxxx--
XXXXXXXXXXXXXXXXXXXXXXXXXXXXXXXXXXXXXXXXXXXXXXXX--