--------------------------------------------------
--------------------------------------------------
--------------------------XXXX--------------------
---------------------------[]---------XX----------
---------------------------[]-------xxxx----------
---------------------------<>------xx<>-x---------
Q---------------------------------xxX[]--x--------
S---------------------------E-----xXX[]---x-------
xx--------x---------------------xxxXX[]----x------
S-x-----------------------xxxx-xx<>XX[]-----x-----
S--xxx-------------------xx---xxX[]XX[]------x----
S--<>-x-----------------xx---<>XX[]XX[]-------xxx-
S--[]--xxxxxxxxxxxxxxxxxx----[]XX[]XX[]-------XX-x
X--XXXXXXXXXXXXXXXXXXXXXX----[]XXXXXXXXXXXXXXXXXXX