----------------------------------------------------------------------------------------------------
-----------------------------------------------------------xxx--------------------------------------
----------------------------------------------------------xx--x-------------------------------------
---------------------------------------------------------xx----xx-----------------------------------
-------------------------xxxxx--------------------------xx-----E-xxxxxx------xxxxxx-----------------
------------------------xxXXX-x-----------------------xxx---------x----x----xxXXX--x----------------
-----------------------xx-XXX--x---------------------xx-S--------<>-----x--xxXXXX---x---------------
----------------------xx--XXX---x-------------------xx-----------[]------xxx-XXXX----x--------------
--xxxx---------------xxXX-XXX----x----------------xxx------------[]-------xB-XXXX-----x-------------
-xx<>-x-------------xxXXX-XXX-----x-------SSS----xx<>------X-----XX-------XXXXXXX------x------------
xx-[]--x-----------xxXXXX-XXX------x------------xx-[]--------------------XXXXXXXX-------x-----------
x--[]---x----xxxxxxxXXXXX-XXX-------xxx--------xx--[]-------------------XXXXXXXXX--------xx---------
-E-[]----xxxxx----xXXXXXX-XXX-------XX-xxxxxxxxx---[]----X-------------XXXXXXXXXX--------X-xxxxxxxxx
XXXXXXXXXXXXXX---XXXXXXX--XXXXXXXXXXXXXXXXXXXXXXXXXXXXXXXX-------------XXXXXXXXXXXXXXXXXXXXXXXXXXXXX