----------------------------------------------------------------------------------------------------
----------------------------------------------------------------------------------------------------
XXXSSSSSSSSSSSSSSSSSSSSSSSSSSSSSSSSSSSSSSSSSSSS?SSSSSSSSSSSSSSSSSSSSSSSSSSSSSSSSSSSSSSSSSSSSSSS-----
X--SSSSS--SSS--SSSSSS--SSSS------SSSS--------------------------SSSSSSSSSSSSSSSSSSSSSSS--------------
XX-SSSSS--SSS--SSSSSS--SSSS--E---SSSS--------------------------SSSSSSSSSSSSSSSSSSSSSSS-----------XXX
XSSSSSSS--S----SSS--S---S----SS----------ooooooo---------------SSSSSSSSSSSSSSSSSSSSSSS--QQ------xxxx
XSS-------S----SSS--S---S----SS----------------------------------------------------------------xx---
XSS-------S----SSS--S---S----SS----------SSSSSSS--------------xxx-xxx----------------xxx-xxx--xx----
XSS-------So??-SSSooS---So??-SS---E------SSSSSSS-------------xxxxxx?-xxxxxxxxxxxxxxxxx--xx--xxx-----
XSSS?SSS--SSS--SSSSSS---SSS--SS--SSSS------------------------x-SSSS??SSSSSSSSSSSSSSSSS--QQ--QQQ-----
---S--------------SS------------EE--------------------------xx-SSSSS-S-SSSSSSSSSSSSSSS--------------
---S--------------SS----------------xxxxx------------------xx--SSSSS-S-SSSSSSSSSSSSSSS--------------
xxxxxxxxxxxxxxxxxxxxxxxxxxxxxxxxxxxxx----xxxxxxxxxxxxxxxxxxx--------oS-SSSSSSSSSSSSSSS--------------
XXXXXXXXXXXXXXXXXXXXXXXXXXXXXXXXXXXXX---XXXXXXXXXXXXXXXXXXXXXXXXXXXXXXEXXXXXXXXXXXXXXXXXXXXXXXX-----