----------------------------------------------------------------------------------------------------
----------------------------------------------------------------------------------------------------
----------------------------------------------------------------------------------------------------
----------------------------------------------------------------------------------------------------
-----------------------------------------E----------------------------------------------------------
-------------------------------------SSSSSS----S----------------------------------------------------
---------------------------------------------------------------------------------------xxxx---------
------------------B-------------------------------------------------------------o------xXX-x--------
------------------b-------------------E------------------------------------------E-----xXX--x-------
--QQQQX---------SSXSS-------xxxxx---SSSSSSS---xxxx------------QQQQ------------SSSSSS--xxXX---x------
E-----X---B----------------xx-<>-x-----------xx<>-x------------------B-----E--E------xxXXX----x-----
--E---X---b-----------B---xx--[]--x---------xx-[]--x-------B--E------b-------------Exx-XXX-----x----
xxxxxxxxxxxxxxxxxxxxxxxxxxx---[]---xxxxxxxxxx--[]---xxxxxxxxxxxxxxxxxxxxxxxxxxxxxxxxx--XXX------xxxx
XXXXXXXXXXXXXXXXXXXXXXXXXXX--XXXXXXXXXXXXXXXXXXXXXXXXXXXXXXXXXXXXXXXXXXXXXXXXXXXXXXXXXXXXXXXXXX-XXXX