--------------------------------------------------
--------------------------------------------------
--------------------------------------------------
--------------------------------------------------
--------------------------------------------------
--------------------------------------------------
--------------------------------------------------
--------------------------------------------------
------------------------------------E-------------
?S-----------------------------QQQQQ>QQQQQQ?------
------------------XXXXXXXXXXXXX-----]-------------
B-----?-----------------------------]-------------
b-E----------E----------------------]------B------
XXXXXX-XXXXXXXXXXXXXXXXXXXXXXXXXX-XXXXXX-XXXXXXXXX