----------------------------------------------------------------------------------------------------
-------------------------------------------------------xx-------------------------------------------
----------E-------------------------------------------xx-x------------------------------------------
-----------------------------------------------------xx---x-----xxx---------------------------------
xxxx-------------------------------------------xxxxxxx-----xxxxxx--x--------------------------xxxxxx
xXX-x---------------------------------------xxxx---XXX-----XXXXXXE--x------------------------xxXXXXX
XXX--x------------------X------------------xxXXX---------------------x-------------E--------xx------
XXX---x----------------XX-----------------xx--------------------------x--------------------xx-------
XXX----x--------------XXX-------------xxxxx----------------------------x-----------xx-xxxxxx--------
XXX-----x-----------XXXXX------------xx-XXX--------XXX------------------x---------xx-xx--XXX--------
XXX------x----------XXXX------------xx-----------------------------------xxxxxx--xx--XX-------------
XXX-------xxx-------XX-------xxx---xx-------------------------------------x----xxx------------------
xXX-------XX-xxxxxxxxxxxxxxxxx--xxxx------------------------------XXXXEXXEX----XXX------------------
XXXXXXXXXXXXXXXXXXXXXXXXXXXXXX--XXXX----------------------------------------------------------------