----------------------------------------------------------------------------------------------------
----------------------------------------------------------------------------------------------------
SSSSSSSSSSSSSSSSSSSSSSSSSSSSSSSSSSSSSSSSSSSSSSSS?SSSSSSSSSSSS-SSSSSSSSSSSSSSSSSSSSSSSSSSSSSSSSSSSSSS
----------------------------------------------------------------------------------------------------
----------------------------------------------------------------------------------------------------
----------------------------------------------------------------------------------------------------
------------xx----------------------------------xxxxx-----------------------------xx----------------
-----------xx-x-xxx------------------------xxxxxx----x-----------------[---------xx-x-xxx-----------
----------xx---xx--x---------------------xxxXXXXX-----xx------------------------xx---xx--x----------
xx------xxx----<>---x------xxxx---------xxX>XXXXX----<>-xxx----xxxxx----------xxx----<>---x------xxx
--xxx--xx<>----[]----xxx--xxSS-x-------xxEX]XXXXX----[]<>]-x--xx-SS-x--------xx<>----[]----xxx--xxSS
--<>-xxx-[]----[]----<>-xxx-SS--x-----xxXXX]XXXXX----[][]]--xxx--SS--x------xx-[]----[]----<>-xxx-SS
E-[]--x--[]----[]--E-[]--x--SS---xxxxxxXXXX]XXXXX----[][]]---x---SS---xxxxxxx--[]----[]--E-[]--x--SS
XXXXX-XXXXXXXXXXXXXXXXXXXX--XX--XXXXXXXXXXXXXXXXX--XXXXXXXXXXX---SX--XXXXXXXXXXXXXXXXXXXXXXXXXXX--XX