--------------------------------------------------
--------------------------------------------------
---------------XXXX-------------------------------
----------------[]---------xxxxx------------------
----------------[]-------xxx----x-----------------
----------------<>------xx<>-----x----------------
-----------------------xxX[]------x---------------
-----------------E-----xXX[]-------x-----------xxx
-xxxx----------------xxxXX[]--------x--xxx---xxx--
xx<>-x---------xxxx-xx<>XX[]---------xxxS-x-xxXX--
x-[]--x-------xx---xxX[]XX[]----------x----xxXXX--
--[]---x-----xx---<>XX[]XX[]----------SS-SSxXXXX--
[-[]----xxxxxx----[]XX[]XX[]--------X-SS-SSXXXXX--
XXXXXXXXXXXXXX----[]XXXXXXXXXXXXXXXXXXXXXX-XXXXX--