----------------------------------------------------------------------------------------------------
--------------------------------------------------------------------------------xxxx----------------
]SSSSSSSSSSSSSS---------------------------------S---------XXX-------------------x---x---------------
]SSSSSSSSSSSSSS-------------------XXXXXXXXXXXX--S-----------------------xxx----<>----x--------------
]SSSSSSSSSSSSSS------------------XX-------------S---------------xxx----xxE-xxxx[]-----x-------------
]SSSSSSSSSSSSSS-----------------XXX-------------S--------------xx--x--xx---XXXXXX------x---------SSS
]SSSSSSSSSSSSSS----------------XXXX-------------S-------------xx-E--xxx-----------------x-----------
SSSSSSSSSSSSSSS---------------XXXXX-------------S------------xx-----XXX------------------x--xxx-----
SSSSSSSSSSSSSSS--------------XXXXXX-------------S--------xxxxx----------------------------xxxB-xxxxx
SSSSSSSSSSSSSSS--------E----XXXXXXX-------------S-------xx-XXX-----------------------------xXXXXESSS
SSSSSSSSSSSSSSS---E---<>---XXXXXXXX-----<>------S------xx---------------------------------XXXXXXX---
SSSSSSSSSSSSSSS--<>---[]--XXXXXXXXX-----[]------S-----xx----------------------------XX----XXXXXXX---
SSSSSSSSSSSSSSS--[]---[]-XXXXXXXXXX-----[]------Sxxxxxx-----------------------------------XXXXXXX---
XXXXXXXXXXXXXXX--XX---XXXXXXXXXXXXXXXXXXXXXXXXXXXxXXXXX-----------------------------------XXXXXXXXXX