--------------------------------------------------
--------------------------------------------------
--------------------------------------------------
--------------------------------------------------
------------------------------xxxxxxxxxxx---------
-----------SS----S-----------xx--QQQ?QQQ-x-------S
----------------------------xx------------x-------
---------------------------xx------E-------x------
---------SS--------------xxx-----SSSSSSS----x-----
xx-xxx---------QQQQ-----xx<>--------------E--x----
--xx--xxx--------------xx-[]-------X------X---x---
--<>--<>-x-xxxxx------xx--[]-------X------X----x--
x-[]--[]--xx----xxxxxxx---[]----E--X------X-----xx
XXXXXXXXXXXX-X-XXXXXXXXXXXXXXXXXXXXXXXXXXXXXXXXXXX