----------------------------------------------------------------------------------------------------
----------------------------------------------------------------------------------------------------
---------------------------------------------------------------------------------------SSS--[]SSSSSS
--------------------------------------------------------------------------------------------[]SSSSSS
--------------xxxxxxxxxxx----------E-E------------------xxxxx-------------------------------[]SSSSSS
-E-----------xx--QQQ?QQQ-x-------SSSSSSS-SS-xxxx-----xxxx--X-x-------------xx--xxxxx--------[]SSSSSS
<>----------xx------------x-------------E--xx---x---xx--E--X--x-----------xx-xxx----x-------[]SSSSSS
[]---------xx------E-------x--------------xx-----x-xx---XX-X---x--------xxx--XXX-----x------[]SSSSSS
XX-------xxx-----SSSSSSS----x-----------xxx-------xx----XX-X----x--------x------------x------]SSSSSS
--------xx<>--------------E--x---------xx<>-------<>----XX-X-----x---------------------xxxxx-]SSSSSS
x>-----xx-[]-------X------X---x---E---xx-[]-------[]----XX-X------x-------------SSS-S--SSSSSSSSSSSSS
-]x---xx--[]-------X------X----x-----xx--[]-------[]----XX-X-------S------------SSS-S--SSSSSSSSSSSSS
-]-xxxx---[]----E--X------X-----xxxxxx---[]-------[]----XX-X-------xxxxxx-------SSS-S--SSSSSSSSSSSSS
XXXXXXXXXXXXXXXXXXXXXXXXXXXXXXXXXXXXXXXXXXX-------XX-XXXXX-XXXXXXXXXXXXXXX---XXXSSS-S--XXXXXXXXXXXXX