--------------------------------------------------
--------------------------------------------------
-----------------------XXXX-----------------------
------------------------[]---------xxxxx----------
xxxx--------------------[]-------xxx----x---------
----x-------------------<>------xx<>-----x--------
-----x-------------------------xxX[]------x-------
XX----x------------------E-----xXX[]-------x------
-------x---------------------xxxXX[]--------x--xxx
--------xxx-x----------xxxx-xx<>XX[]---------xxxS-
---------xxx-x--------xx---xxX[]XX[]----------x---
-----------X--x------xx---<>XX[]XX[]----------SS-S
xx---------X---xxxxxxx----[]XX[]XX[]--------X-SS-S
XXXXX------XXXXXXXXXXX----[]XXXXXXXXXXXXXXXXXXXXXX