--xxx----------------------------------------------------------------------------------xxx----------
-xx--x-------xxx----------------------------------------------------------------------xx--xx--------
xx----x-----xx--x--------------------------------------------------------------------xx----x--------
x------x---xx------------------------------------------------------------------xxxxxxx------x-------
x-------x-xx-----x------------------------------------------------------------xx----x--------x------
xS-------xx-------x-------xx---------------------------SSSSS-----SSSSS--------xX----E---------x-----
x--------XX--------x-----xx-x-------------------------S-----------[]---------xx----<>----------x----
S-------------------x---xx---xxx---------------------SS-----------[]---------x-----[]-----------xxxx
---------------------xxxx-----x-x-------------------SSS-------?---[]-------xxx-----[]------------x--
o--------------------XXXX-----S--xS----------------SSSS-----------<>------xx<>-----[]------------?--
o---------------------------------x--------------------------------------xx-[]-----[]---------------
-----------------------------------x------xxx-----xxx----------xxx-E----xx--[]-----[]---------------
-----------------oooo---------------xxxxxxxE-xxxxxxB-xxxxxxxxxxxB-xxxxxxx---[]-----[]------E--------
XXXXX------------SXXX---------------XXXXXX<>XXXXXXXXXXXXXXXXXXXXX-XXXXXXXEXXXX-----XXXXXXX<>XXXXXX--