----------------------------------------------------------------------------------------------------
----------------------------------------------------------------------------------------------------
SSSS------------------------------------------------------------------------------------------------
SSS------------------------------------------------------------------------------xxxxxxx------------
SSS----------------------------------------------xxx-------------------xxxx----xxx--XXX-x-----------
SSS--------------xxxxx--------------------------xxXXx-----------------xx---x--xxXS-------x----------
----------------xx-<>-x------------------------xxXXX-x---------------xx-----xxxEX---------x---------
---------------xx--[]--x----------------------xxXXXX--x-------------xx-------xXXX----------x--------
x------------xxx---[]---x--------------------xxXXXXX---x----------xxx--------XXXXS----------x-------
-x----------xx<>--QQQ?---x------------------xxXXXXXX----x--------xx<>-------XXXXX--------E---x------
S-x--------xx-[]----------x-------xxxx-----xxXXXXXXX-----x------xx-[]------XXXXXX-------<>----x-----
S--x------xx--[]-----------x-----xx<>-x---xxXXXXXXXX------x----xx--[]-----XXXXXXX-------[]-----xxx--
SE--xxxxxxx---[]------E-----xxxxxx-[]--xxxxXXXXXXXXX-------xxxxx---[]----XXXXXXXX-------[]-----XX-xx
XEXXXXXXXXXXXXXXX-----X---XXXXXXXXXXXXXXXXXXXXXXXXXXXXXXXXXXXXXXXXXXXXXXXXXXXXXXXXXXXXXXXXXXXXXXXXXX