----------------------------------------------------------------------------------------------------
-----------------------------------xxx--------------------------------------------------------------
----------------------------------xx--x-------------------------------------------------------------
---------------------------------xx----xx-----------------------------------------------------------
---------E----------------------xx-----E-xxxxxx-----------------------------xxxxxxxxxxxx----------E-
-----SSSSSS---S---------------xxx---------x----x-------S-------------------xx---QQQ?QQQ-x-------SSSS
-----------------------------xx-S--------<>-----x-------------------------xx-------------x----------
----------------------------xx-----------[]------xxxx--xxxxx-------------xx-------E-------x---------
------E--------------------xx------------[]-------xB-xxx----xx---------xxx------SSSS-SS----x--------
----SSSSSSS--xxxx----------x-------X-----XX-------XXXXES---<>-x-------xx<>--X------------E--x-------
xx----------xx<>-x-------xxx---------------------XXXXXX----[]--x-----xx-[]--------X------X---x---E--
>-x--------xx-[]--x-----xx<>--------------------XXXXXXX----[]---x---xx--[]--------X------X----x-----
]--xxxxxxxxx--[]---xxxxxx-[]-----X-------------XXXXXXXX----[]----xxxx---[]----E---X------X-----xxxxx
XXXXXXXXXXXXXXXXXXXXXXXXXXXXXXXXXX-------------XXXXXXXXXXXXXXXXXXXXXXXXXXXXXXXXXXXXXXXXXXXXXXXXXXXXX