----------------------------------------------------------------------------------------------------
-------xx-------------------------------------------------------------------------------------------
------xx-x------------------------------------------------------------------------------------------
-----xx---x-----------------------------------------------------------------------------------------
-xxxxx-----x----------------------------------------------------------------------------------------
-xSSSS------x---------xx------------------------------SSSSSSSSSSSSS-------------------SSS?SSS-------
-x-----------x-------xx-x---------------------------------------------------------------------------
-x------------x-----xx---xxx------------------------------xxxxxxx-----<>----------------------------
xx-------------xxxxxx----<>-x---Q--Q--?-----------------xxxSSSSS-x----[]----------------------------
xX-----X------SSSSSS?----[]--x--------------S---------xxxSS-------x--QQQQQQ-----------SSSSSSS-------
-X-----------------------[]---x-----------E----------xx<>----------x-------------------------------x
-X------------------S----[]----x------E-----xxxxxx--xx-[]-----------x-xxxxx---xxx---------xxxxxxxxxx
EX-----------------------[]-----xxxxxxxxxxxxx---X-xxx--[]----E---EE--xx----xxxxE-xxxxxxxxxx---x---x-
XXXXXX---------XXXXXXX---XXXXXXXXXXXXXXXXXXXX---XXXXXXXXXXXXXXXXXXXXXXX-X-XXXXXXXXXXXXXXXXX-X-X---X-