----------------------------------------------------------------------------------------------------
-----------------------------------------------------------------------xx---------------------------
---------------------------------------------SSSSSSSSSSSSSSSSSSSSSSS?SSSSSSSSSSSSSSSSSSSSSSSSSSSSSSS
---------xxx----------------------------------------------------------------------------------------
------xxxx--xX------------------xxxx----------------------------------------------------------------
-----xx--X---x-----------------xxXX-x-------------------------------------------------------E-E-----
----xx--------x---------------xxXXX--x------------------------------xxxxx------------------<><>-----
---xxE---------x-------------xxXXXX---x------------------------xxxxxx----x-----------------[][]-----
-xxx<>----------x-----------xxXXXXX----x----------------------xxXXXXX-----xx---------------QQQQ-----
xx<>[]-----------x---------xxXXXXXX-----x-------------xxxx---xxXXXXXX----<>-x-----xxxx--------------
x-[][]------------x-------xxXXXXXXX------x----------Exx---x-xxXXXXXXX----[]--x---xxSS-x------------x
-X[][]-------------x-----xxXXXXXXXX-------x---------xx-----xxXXXXXXXX----[]---x-xx-SS--x----------xx
XX[][]------------X-xxxxxxXXXXXXXXX--------xxxxxxxxxxX-----XXXXXXXXXX----[]----xx--SS---xxxxxxxxxxx-
XXXXXXXXXXX-------XXXXXXXXXXXXXXXXXXXXXXXXXXXXXXXXXXXX-----XXXXXXXXXX--XXXXXXXXXX--XX--XXXXXXXXXXXXX