----------------------------------------------------------------------------------------------------
----------------------------------------------------------------------------------------------------
----------------------------------------------------------------------------------------------------
-----------------------------------o----------------------------------xxx---------------------------
xxx---xxx---------------------------------------------------xxxx----xxx--x--xxx-------------------xx
x--xx-x--x-----------------------SSS-------E---------------xx---x--xxXS---xxx--x-----------------xx-
----<x>---x-------------------------------<>--------------xx-----xxxEX-----<>---x---------------xx-E
----[-]----x------------------xxxxxxxxx---[]-------------xx-------xXXX-----[]----x-------------xx---
S---[-]-----x---------------xxx---x----xx-XXX----------xxx--------XXXXS----[]-----x--xxx---xxxxx----
----XEX------x------SSS----xx<>---S---<>-x------------xx<>-------XXXXX-----[]------xxxS-x-xx-XXX----
----->--------x-----------xx-[]-------[]--x-xxxxxx---xx-[]------XXXXXX-----[]-------x----xx---------
x----]---------x---------xx--[]-------[]---xx<><>-x-xx--[]-----XXXXXXX-----[]-------SS-SSx----------
o----]--------X-xxxxxxxxxx---[]----E--[]----x[][]--xx---[]----XXXXXXXX-----[]-----X-SS-SSX----------
X--XXXXXXXXXXXXXXXXXXXXXXXXXXXXXXXXXXXXXXXXXXXXXXXXXXXXXXXXXXXXXXXXXXXXXXXXXXXXXXXXXXXXX-X----------