----------------------------------------------------------------------------------------------------
----------------------------------------------------------------------------------------------------
----------------------------------------------------------------------------------------------------
----------------------------------------------------------------------------------------------------
----------------------------------------------------------------------------------------------------
--------------------------------------------------------------------------------------------SSSS----
E----------------------------------------xxx--------------------------------------------------------
----xxxxxx------------------------------xxX-x-------------------------------------------------------
xxxxx--<>-x----------------------------xxXX--xo------o----o---------------------oo--------------xxxx
x--<>--[]--x--------------------------xxXXX---x--------------------xxxx--------xxxx--------S---xx<>-
>--[]--[]---x------------------------xxXXXX----x------------------xx---xx-----xx---x----------xx-[]-
]--[]--[]----x----------------------xxXXXXX-----x--xxxxxxxxxx----xxX--XX-x---xx-----x--------xx--[]-
]--[]--[]-----xxxxxxxxxxxxxxxxxxxxxxxXXXXXX------xxx----x----xxxxx-X------xxxx-------xxxxxxxxx---[]-
X--XX--XXXXXXXXXXXXXXXXXXXXXXXXXXXXXXXXXXXXXXXXXXXXX---XX---XXXXXXXXX-----XXXX------XXXXXXXXXXXXXXXX