----------------------------------------------------------------------------------------------------
----------------------------------------------------------------------------------------------------
----------------------------------------------------------------------------------------------------
----------------------------------------------------------------------------------------------------
----------------------------------------------------------------------------------------------------
-S-xxxxx--------------------------xxx-----------------------------------------------E-E-E-----------
--xx-<>-x------------------------xxX-x---------------------------------------------<><><>-----------
-xx--[]--x----------------------xxXX--x--------------xxxxx-------------------------[][][]-----------
xx---[]---x--------------------xxXXX---x----------xxxx-<>-x--------------------Q?--QQQQQQ-----------
<>--QQQ?---x------------------xxXXXX----x--------xxQQ?-[]--x--------------------------------------Q-
[]----------x-------xxxx-----xxXXXXX-----x------xx-----[]---x--------------------------------xxxx---
[]-----------x-----xx<>-x---xxXXXXXX------x----xx------[]----x------------------xxx---------xx<>-x-x
]]------E-----xxxxxx-[]--xxxxXXXXXXX-------xxxxx--X----[]-----xxxxxxxxxxxxxxxxxxx--xxxxxxxxxx-[]--xx
XX------X---XXXXXXXXXXXXXXXXXXXXXXXXXXXXXXXXXXXXXXXXXXXXXXXXXXXXXXXXXXXXXXXXXXXXX--XXXXXXXXXXXXXX-XX