----------------------------------------------------------------------------------------------------
----------------------------------------------------------------------------------------------------
----------------------------------------------------------------------------------------------------
--------------------------------------------------o-------------------------------------------------
-----------------------------------------------------------------------------xxxx-------------------
-------E--------------------S-------------------SSS-------E---------SS------xx---x------------------
---------------------------------------------------------<>----------------xx-----x--E--------------
---------------------------xxxxx-------------xxxxxxxxx---[]----------------x-------x-xxxxx----xxxx--
--------------------------xx----xx---------xxx---x----xx-XXX-------------xxx--------xx----x-xxx---x-
-----------xxxx----------xx----<>-x-------xx<>---S---<>-x--------QQQ-xxxxx-?--------<>-----xx<>----x
xxxx------xx---xx------xxx-----[]--x-----xx-[]-------[]--x-xxxxxx---xx--<>----------[]----E<>[]---<>
x<>-x----xx---<>-x----xx<>-----[]---x---xx--[]-------[]---xx<><>-x-xx---[]----<>----[]---<>[][]---[]
-[]--x--xx----[]--xxxxx-[]--E--[]----xxxx---[]----E--[]----x[][]--xx----[]----[]----[]---[][][]---[]
XXXX--xxx-----[]--XXXXXXXXXXXXXXXXXXXXXXXXXXXXXXXXXXXXXXXXXXXXXXXXXX--X-XXXXXXXXXXXXXXXXXXXXXXXXXXXX