----------------------------------------------------------------------------------------------------
----------------------------------------------------------------------------------------------------
----------------------------------------------------------------------------------------------------
----------------------------------------------------------------------------------------------------
-------------------------------------------------------------------------------------------oo-------
----------------------------------------------------------------------------------------------------
--X---oooo-------------------------o-----oooo------------oooo------------oooo-----------------------
---------------------xxxxx--------------------------------------------------------------------------
--xxxx-------------xxx--S-x------o---xxxx------------xxxx------------xxxx------------xxxx----------x
-xx<>-x-----------xx<>-----xx-------xx<>-x----------xx<>-x----------xx<>-x----------xx<>-x--------xx
xx-[]--x---------xx-[]----<>-x-----xx-[]--x--------xx-[]--x--------xx-[]--x--------xx-[]--x-----xxx-
x--[]---x-------xx--[]----[]--x---xx--[]---x------xx--[]---x------xx--[]---x------xx--[]---x---xx<>-
---[]----xxxxxxxx---[]----[]---xxxx---[]----xxxxxxx---[]-E--xxxxxxx---[]----xxxxxxx---[]-E-Exxxx-[]-
XXXXXXXXXXXXEXXXXXXXXXXXXXXXXXXXXXXXXXXXXXXXXXXXXXXXXXXXXXXXXXXXXXXXXXXXXXXXXXXXXXXXXXXXXXXXXXXXXXXX