----------------------------------------------------------------------------------------------------
----------------------------------------------------------------------------------------------------
----------------------------------------------------------------------------------------------------
----------------------------------------------------------------------------------------------------
----------------------------------------------------------------------------------------------------
------------------------------------------------------------------------------------------SSSSSSS---
----------------------------------------------------------------------------------------------------
---xx-----------------------------------------------------------------------------------------------
--xx-xx----S--x----------------------------------------------------------------------------E--E-----
-xx-->-x-------------------------------------------ooo------------------------------------SSSSSSS---
xx---]--x--------------------------------------------------------------------------Q?QQ-------------
x----]---x-----xxx-------Exxx-----------xxxx---------xxx-----xxxx----------------------------xxx----
E--X-]----xxxxxx--xxxxxxxxx--xxxxxxxxxxxxEE-xxxxxxxxxx--xxxxxxEE-xxxxxxxxxxxxxxxxxxxxxxxxxxxxx--xxxx
XXXXXXXXXXXXXXXX--XXXXXXXXX--XXXXXXXXXXXXXXXXXXXXXXXXX--XXXXXXXXXXXXXXXXXXXXXXXXXXXXXXXXXXXXXX--XXXX