--------------------------------------------------
--------------------------------------------------
--------------------------------------------------
--------------------------------------------------
---------------------------ooo--------------------
---------------------------ooo--------------------
--------------------------------------------------
Q------xx-----oooo---------xxxx--------xxx--------
------xx-x----oooo--------xx---xxxxxxxxx--x-------
-xxxxxx---x-------------Exx---XXXXXXXEXX---x------
xx---x-----xxxxxxxxxxxxxxx----X--------X----xxxxxx
X----X-----XXXXXXXXXXXXXXX----X--------X---XXXEXXX
x----X-----X-------------X----X--------X---X------
X----X-----X-------------X----X--------X---X------