----------------------------------------------------------------------------------------------------
----------------------------------------------------------------------------------------------------
SSSSSSSSSSSSSSSSSSSSSSSSSSSSSSSSSSSSSSSSSSSS-SSSSSSSSSSSSS------------------------------------------
[]--------------------------------------------------------------------------------------------------
[]---------------------E--------------xxx-----------------------------------------------------------
[]-----------------QQQQQQ-------xxxxxxx--x------------------------------xxx-------------------------
<>-----------------------------xxSSSSSS---xxxxx------------------------xx--x------------------------
[xxxx-xxx---------------------xx-SSSSSS---SSSS-x----------------------xx----xxxxx-------------------
xx---xx--x--------xxxxxxxxxxxxx--SSSSSS---SSSS--xxxxxxxxx-----------xxx------xXX-x------------------
x----<>---x------xxSSSSSSSSSSSS--SSSSSS---SSSS?SS?SSSS??-x---------xx<>-----XXXX--xxx----SSS----E--S
-----[]----xxx--xx-SSSSSSSSSSSS------------------S-SSSSS--x-------xx-[]--SSSXXXX--<>-x---------<>---
-----[]----<>-xxx--SSSSSSSSSSSS--------<>>-------S-SSSSS<>-xx----xx--[]--SSSXXXX--[]--x-------------
-----[]--E-[]--x---SSSSSSSSSSSS--------[]]--------------[]---xxxxx---[]--SSSXXXX--[]---xxxxxxxxxxxxx
XXXXXXXXXXXXXXXX---XXXXXXXXXXXXXXXXXXXXXXXXXXXXXXXXX-XXXXXX--XXXXXSXXXXXXSXXXXXXXXXXXX-XXXXXXXXXXXXX