--------------------------------------------------
--------------------------xx----------------------
-------------------------xx-x---------------------
------------------------xx---x----xxxxx-----------
-----------------------xx-----xxxxx----x----------
----E------------------xS-----SSSSS-----xxxx------
---<>-----------------xx-----------------x--x-----
---[]-------------xxxxx-----------------<>---x---x
x--XXX----------xxx---------------------[]----x-xx
-xx------------xx<>---SS----------ES----[]-----xx-
]]-x-xxxxxx---xx-[]---------E----<>---E-[]-----<>-
[]--xx<><>-x-xx--[]--------<>----[]--<>-[]-----[]-
[]---x[][]--xx---[]-------X[]----[]--[]-[]-----[]-
XXXXXXXXXXXXXXXXXXXXXXXXXXXXXXXXXXXXXXXXXXXXXXXXXX