--------------------------------------------------
--------------------------------------------------
--------------------------------------------------
--------------------------------------------------
--------------------------------------------------
--------------------------------------------------
--------------------------------------------------
-------------------------------xxxxxx-------------
-------------oo------------xxxxx--<>-x------------
xx----------xxx----------xxx--<>--[]--x-----------
SS---------xx--x--------xx<>--[]--[]---x----------
SSxx------xx----x------xx-[]--[]--[]----x---------
SSX-xxxxxxx------xxxxxxx--[]--[]--[]-----xxxxxxxxx
XXXXXXXXXXX-----XXXXXXXXX-XX--XX--XXXXXXXXXXXXXXXX