----------------------------------------------------------------------------------------------------
-------------------------------------------------------------------------------------------------xxx
-------------------------------------------------SS-SSSSSSSSSSSSSSSSSSSSS?SSSSSSSSSSSSSS--------xxSS
-------------------------------------------------SS---SSSSSSSSSSSSSSSSSSSSSSSSS----------------xx---
---------------------------------------E------S-?SS---SSSSSSSSSSSSSSSSSSSSSSSSS-----------XXX-xx----
-----------------------------------SSSSSSSSSS---------SSSSSSSSSSSSSSSSSSSSSSSSS--QQ------xxxx-xSSS--
----------------------------------------------------------------------------------------xx---xx-----
-------------------------------------------------------------xxx--------------xxx-xxx--xx-----xS----
x------------xxxx-------------------------------------xxxxxxxx?-xxxxxxxxxxxxxxx--xx--xxx------S-S---
-x----------xx<>-x-------------------xxx---SSSSSSS---xx-SSSSSS??SSSSSSSSSSSSSSS--QQ--QQQ---------S--
>-x--------xx-[]--x-----------------xxX-x-----------xx--SSSSS---SSSSSSSSSSSSSSS---------------------
]--x------xx--[]---x----xxxxxxxxxx-xx-X--x---------xx---SSSSS---SSSSSSSSSSSSSSS---------------------
]E--xxxxxxx---[]----xxxxx----x----xx--X---xxxxxxxxxx---------oooSSSSSSSSSSSSSSS---------------------
XXXXXXXXXXXXXXXXXXXXXXXXX-X-XX-XX-XXXXXXXXXXXXXXXXXX---XXXXXXXXXXXXXXXXXXXXXXXXXXXXXXXXX------XXXXXX