-----------------------------------xxx--------------------------------------------------------------
----------------------------------xx--x-------------------------------------------------------------
---------------------------------xx----x------------------------------------------------------------
---------------------------xxxxxxx------x-----------------------------------------------------------
--------------------------xx----x--------x---------xxxxxxxx-----------------------------------------
---SSSSS-----SSSSS--------xX----E---------x-------xx--?SSS-x-----------------------------XX---------
--------------[]---------xx----<>----------x-----xx---------x----------------------------[]---------
--S-----------[]---------x-----[]-----------xxxxxxE---------Ex---------------------------[]---------
-SSx------?---[]-------xxx-----[]------------x---<>--------<>-x--------------------------[]---------
SSSS----------<>------xx<>-----[]------------?---[]-----E--[]--x------------------xxx----<>SSSSSS---
---------------------xx-[]-----[]----------------[]----<>--[]---x----------------xxX-x--------------
xx---------xxx-E----xx--[]-----[]----------------[]----[]--[]----x-xxxxx-------Exx-X--x---Exxx------
B-xxxxxxxxxxB-xxxxxxx---[]-----[]------E---------[]----[]--[]-----xx----xxxxxxxxx--X---xxxxxE-xxxxxx
XXXXXXXXXXXXX-XXXXXXXEXXXX-----XXXXXXX<>XXXXXX---XXXXXXXXXXXXXXXXXXX---XXXXXXXXXX--XXXXXXXX<>XXXXXXX