----------------------------------------------------------------------------------------------------
------------------------------------------------------------------------------------------------xx--
--------------------------------------------------------------------------------------------------x-
---------------------------------------------------------------------------------------------------x
----------------------------------------------------------------------------------------------------
-ESSSS-----SSSS-----------------xxxxS-------SSS--------SSSSS---------xxxxS--------------------------
------------[]X----------------xx--xxx-----------------[]-----------xx--xxx---xxxxxxx---------------
------------[]----------------xx------x-xxx------------[]----------xx------x-xxXXXXX-x--------------
------------[]---------------xx----E-EExx--xx----------[]--------xxx----E-E-xxXXXXX---x-------------
------------[]----------xxxxxxX--------XX-XX-x-------x-<>-------xx<>--------XXXXX------x------------
------------<>---------xxE--xXXX-------XX-XX--x----------------xx-[]--------XXXXX-------xxxxxxxxx---
x-----------xxx-------xx<>-XXXXX-------XX-XXX--x--------------xx--[]--------XXXXX-------XXXEXXXXX---
-xxxxxxxxxxxxE-xxxxxxxx-[]-XXXX--------X--XXX--Exxxxxxxxxxxxxxx---[]--------XXXXX->-----X-------X---
XXXXXXXXXXXXXXXXXXEXXXXXXXXXXXX--------X--XXXXXXXXXXXXXXXXXXXXXEXXXX--------XXXX--]-----X-------X---