----------------------------------------------------------------------------------------------------
----------------------------------------------------------------------------------------------------
----------------------------------------------------------------------------------------------------
----------------------------------------------------------------------------------------------------
-----------------xxxxxx--------------------------------------E--------------------------------------
----------------xxSSSS-x-----------------------------------SSSSSSSS---SSSQ-----------------------xxx
SSSS-----------xx-------x-----------------------------------------------------------------------xx--
--------------xx---------x--------------------------------E------------------------------------xx---
-------------xxX----------x--------xxxx----S-------------------------------------------------x-x----
-E----S?S---xxEX--S--------x------xx<>-x----------------S?S--------------S-----SS-----------xxxX----
->---------xxXXX------------x----xx-[]--x---------------------------------------------E----xxXxXX---
----------xxXXXX---------X---x--xx--[]---x-----xxx--------------xxxxx----------------<>---xxXXXXX---
xxxxxxxxxxxXXXXX---EE---XX---Exxx---[]-E--xxxxxx--xxxxxxxxxxxxxxx----xxxxxxxxxxxxxxxxxxxxxxXXXXX----
XXXXXXXXXXXXXXXXXXXXXXXXXXXXXXXXXXXXXXXXXXXXXXXX--XXXXXXXXXXXXXXX---XXXXXXXXXXXXXXXXXXXXXXXXXXXX----