----------------------------------------------------------------------------------------------------
----------------------------------------------------------------------------------------------------
----------------------------------------------------------------------------------------------------
----------------------------------------------------------------------------------------------------
S----------------------------------------------------------------------xxx--------oo----------------
---------------------------------SSSSSSS--------xxx-------------------xx--x-------------------------
-----------------------------------------------xx--x-----------------xx----x------------------------
----------------------------------------------xx--------------------xx------x-----------------------
-------S----xxxx------xxx----------xxxxxx----xx---------------o---xxx--o-----xxx--------------------
S----------xx<>-x----xx--x-------xxxSSS-xxx-xx------xxxx---------xx<>--------<>-x-------------------
----------xx-[]--x--xx----x-----xx<>-------xx-------SSS-x-------xx-[]--------[]--x-----xxxx---------
xxxxxxx--xx--[]---xxx------xxx-xx-[]-------<>-------SSS--x-----xx--[]--------[]---x---xx<>-x--------
x------xxx---[]----x-------XX-xx--[]-------[]-------SSS---xxxxxx---[]--------[]-E-Exxxx-[]-Exxxxxxxx
X-X---XXXXXXXXXX---X-------XXXXXXXXX-----XXXXXX-----XXXXXXXXXXXXXXXXXXXXXXXXXXXXXXXXXXXXXXXXXXXXXXXX