----------------------------------------------------------------------------------------------------
----------------------------------------------------------------------------------------------------
X---------------------------------------------------------------------------------------------------
----------------------------------------------------------------------------------------------------
-----------------------------------------------------------xxxxxxxxxxx------------------------------
----------------------------------------------------------xx--QQQ?QQQ-x-------SSS?SSS----------SSSSS
-SSSSS-ooo-----------------------------------------------xx------------x----------------------------
--------------------------------------------------------xx------E-------x---------------------------
---xxxx----------xxxx---------------------------------xxx-----SSSSSSS----x-----------------------xxx
--xx--xx--------xx<>-x-XX------------------ooo-------xx<>--------------E--x----SSSSSS---------xxxx--
-xx-----x------xx-[]--x-----------------------------xx-[]-------X------X---x-----------------xx-<>--
xx-------x----xx--[]---x-------xxxxx-xxx-----xxx---xx--[]-------X------X----x-----xxxxxxx---xx--[]--
xX--------xxxxx---[]----xxxxxxxx----xx--xxxxxx--xxxx---[]----E--X------X-----xxxxxx---x--xxxx---[]--
XX-----XXXXXXXXXXXXXXXXXXXXXXXXX---XXX--XXXXXX--XXXXXXXXXXXXXXXXXXXXXXXXXXXXXXXXXXX-X-X--XXXX---XX--