----------------------------------------------------------------------------------------------------
-------------------------------------------------------------------------------xx-------------------
------------------------------------------------------------------------------xx-xx-----------------
-----------------------------------------------------------------------------xx--X-x----------------
----------------------------------------------------------------------------xx---X--x---------------
-------------------------------------------------------SSSSS---?-------xxx--xS---X---x--------------
----xxxx--------------------------------------------------------------xx--x-x----XX---x-------------
---xx---x------------------------------------------------------------xx----xx----XX----x------------
--xx-----xxx-------xxxx----S----------------------------------------xx------x----XX-----x-----------
xxx------<>-x-----xx<>-x--------------------xxx-----S---E---------xxx-------SS---XX------x---------S
-x-------[]--x---xx-[]--x------------------xxX-x-------------E---xx<>------------XX-------x---------
<>-------[]---x-xx--[]---x-----xxx-------Exx-X--x---------------xx-[]------------XX--------x--------
[]--E----[]----xx-E-[]----xxxxxx--xxxxxxxxx--X---xxxxxxxxxxxxxxxx--[]E-----------XX-------X-xxxxxxxx
XXXXXXXXXXXXXXXXXXXXXXXXXXXXXXXX--XXXXXXXXX--XXXXXXXXXXXXXXXXXXXXXXXXXXXXXXXXXXXXXXXXXXXXXXXXXXXXXXX