----------------------------------------------------------------------------------------------------
----------------------------------------------------------------------------------------------------
S?SSSSSSSSSSSSSSSSSSSSSSSSSSSSS?SSSSSSSSSSSSSSSSSSSSSSSSSSSSSSSSSSSSSSSSSSSSSSSSSSSSSSSSSSSSSSSSSSSS
-------------------------------------------------[]-------------------------------------------------
-------------------------------------------------[]-------E-----------------xxx---------------------
--------------------------------xxxx-------------[]---QQQQQQ---------xxxxxxxx--x--------------------
-------------------------------xx-]-x------------[]-----------------xxSSSSSSS---xxxxx---------------
---------------------------xxxxx-----x-xxx-------[]----------------xx-SSSSSSS--SSSSS-x--------------
x-----------------xxx-----xxXXXX------xx--x------[]--xxxxxxxxxxxxxxx--SSSSSSS--SSSSS--xxxxxxxxxxxxxx
ox---------------xx--x---xxXXXXX------<>---x-----[]-xxSSSSSSSSSSSSSS--SSSSSSS--SSSSS?SS?SSSSS??????-
--x-------------xx----x-xxXXXXXX------[]----x----<>xx-SSSSSSSSSSSSSS-------------------SSSSSSSSSSSS-
---xE-xxx------xx------xxXXXXXXX------[]-----x----xx--SSSSSSSSSSSSSS---------<>--------SSSSSSSSSSSS-
-X--xxx--xxxxxxx-------XXXXXXXXX------[]------xxxxx---SSSSSSSSSSSSSS---------[]---------------------
XX--XXX--XXXXXXX-------XXXXXXXXX------XX--XE-XXXXXXE--XXXXXXXXXXXXXXXXXXXXXXXXXXXXXXXXXXX-XX-XXXXXXX