----------------------------------------------------------------------------------------------------
----------------------------------------------------------------------------------------------------
----------------------------------------------------------------------------------------------------
----------------------------------------------------------------------------------------------------
----------------------------------------------------------------------------------------------------
-----------------------xxxxS-------SSS--------------------------------------------------------------
----------------------xx--xxx-----------------------------------------------------------------------
---------------------xx------x-xxx-----------------------------------------------------------------x
--------------------xx----E-EExx--xx----------------E---------------------------------------------xx
-------------------xxX--------XX-XX-x--------------<>-------------------E--S-----E---------------xxX
-------------E----xxXXX-------XX-XX--x---------------------------------<>-------<>-----xxxx-----xxXX
x-----------<>---xxXXXX-------XX-XXX--x-------------------xxxxx-----------------------xx<>-x---xxXXX
ExxxxxxxxxxxxxxxxxXXXX--------X--XXX--Exxxxxxxxxxxxxxxxxxxx----xxxxxxxxxxxxxxxxxxxxxxxx-[]--xxxxXXXX
XXXXXEXXXXXXXXXXXXXXXX--------X--XXXXXXXXXXXXXXXXXXXXXXXXXX---XXXXXXXXXXXXXXXXXXXXXXXXXXXXXXXXXXXXXX