----------------------------------------------------------------------------------------------------
----------------------------------------------------------------------------------------------------
----------------------------------------------------------------------------------------------------
----------------------------------------------------------------------------------------------------
----------------------------------------------------------------------------------------------------
--------------------------------------------------------------------------------------xxx-----------
---------------oooo-------------------------------------------x----------------------xx--x----------
---------------------------------------xxxxx-------------------x------------------xxxx----x---------
-----------xxxx---------------------xxxx-<>-x----------------<>-x---------------xxx-<>-----x--------
E--S------xx<>-x-----------E-------xxQQ?-[]--x---------------[]--x----------xxxxx-?-[]------xxx-----
>--------xx-[]--x---------<>------xx-----[]---x--------------[]---x----QQQQxx--<>---[]------<>-x--Eo
b-------xx--[]---x--------[------xx------[]----x-------------[]----x------xx---[]---[]------[]--x---
xxxxxxxxx---[]----xxxxxxxxxxxxxxxx--X----[]-----xxxxxxxxxxxxx[]-----xxxxxxxX---[]---[]------[]---xxx
XXXXXXXXXXXXXXXXXXXXXXXXXXXXXXXXXXXXXXXXXXXXXXXXXXXXXXXXXXXXXXXXXXXXXXXXXXXX---XXXXXXX-XXXXXXXXXXXXX