----------------------------------------------------------------------------------------------------
---------------------------------------------------------------------------------------------------x
------------------------------------------------SSSSSSSSSSSSSSSSSSSS------------------SSSS?SSSS-----
--------------------------------------------------------------------------------------SSS-----------
--------xxx-----------------------------------------------------------XXX-------------SSS-----------
-------xx--x----------XX-----------------------------------------------------------xxxSSS------xxxxx
------xx----x---------[]----------------------------------------------------------xx--x--xxxxxxx----
-----xx------x--------[]---------------------------------------------------------xx----xxxXXXXXX----
-xxxxx--------x-------[]-----------------------------------------xxxxx-------xxxxx------xXXXXXXX----
xx--<>---------x------<>SSSSSS---------------------xxxx---------xxXXX-xxxx--xx-XXX------XXX---------
<>--[]----------x---------------------------------xxSS-x-------xxEXXX-XXX-xxx----------XXXX---------
[]--[]-----------xxx---Exxx-----------------<>---xx-SS--x-----xxXXXXX------x----------XXXXX---------
[]--[]----E------XX-xxxxxE-xxxxxxxxxxxxxxxxxxxxxxx--SS---xxxxxxXXXXXX-----<>---------XXXXXX--------X
XX--XXXXXXXXXXXXXXXXXXXX<>XXXXXXXXXXXXXXXXXXXXXXXX--XX--XXXXXXXXXXXX------[]---------XXXXXX--------X