--------------------------------------------------
-----E--------------------------------------------
--------------------------------------------------
--------------------------------------------------
-----E--------------------------------------------
S--SSQS-------------------------------------------
--------------------oooo----------oooo------------
--------------------------------------------------
------------------------------xxxx----------------
-----QQQQ--------xxx---------xx<>-x---------------
----------------xxX-x-------xx-[]--x-------SSSX---
xx-------------xx-X--x-----xx--[]---x------------x
E-xxxxxxxxxxxxxx--X---xxxxxx---[]----xxxxxxxxxxxxx
XXXXXXXXXXXXXXXXXXXXXXXXXXXXXXXXXXXXXXXXXXXXXXXXXX