----------------------------------------------------------------------------------------------------
x---------------------------------------------------------------------------------------------------
-x--------------------------------------------------------------------------------------------------
--x-------------------------------------------------------------------------------------------------
---x---------------------xxxxxxx------------------------E-------------------------------------------
----x-------------------xx-SSSS-x-------------------QQQQQQQQQQQ------------------------------------X
-----x-----------------xx--------x-----------------------------------------------------------------[
------x---------------xx----------x----------------------------------------------------------------[
-------x-------------xxX-----------x--------xxxx---------E----------------------SS---------xx------[
--------x-----S?S---xxEX---S-----X--x------xx<>-x--E?QQQQQQQQ------E----E-------SS--------xx-x-----<
---------x---------xxXXX---------X---x----xx-[]--x----------------<>---<>-------SS-------xx---x-----
<>--------x-------xxXXXX---------XX---x--xx--[]---x---------------[]---[]-------SS------xx-----xx---
[]-------X-xxxxxxxxXXXXX----EE---XX---Exxx---[]----xxxxxxxxxxxE---[]---[]-------SSxxxxxxx-----XX-xxx
XXXXXXXXXXXXXXXXXXXXXXXXXXXXXXXXXXXXXXXXXXXXXXXXXXXXXXXXXXXXX<>---[]---[]-XXXXXXXXXXXXXXX-----XXXXXX