-------------------------------------------------------------------------------------------x--------
--------------------------------------------------------------------------------------------xxxxx---
-----------------------------------------------------------E--------------------------------xx---xx-
------------------------------------------------------------------------------------------x-x---<>-x
------------------------------------------------------------------------------------------xx----[]--
QQ?QQQQQQQQQ?QQQQ---------xxx---------------------------SSS?S-----------SSSSS-------------Sx----XX--
--------------[]---------xxX-x-------------------------------------------[]-------------xxxx--------
--------------[]--------xxXX--x---------------xxxxx----------------------[]------------xx--x--------
--------------[]-------xxXXX---x-----------xxxx-<>-x---------------------[]-----------xx---S--------
-SSSSSSSSSSSS-<>------xxXXXX----x---------xxQQ?-[]--x------------Q-------[]----------xx-------------
---------------------xxXXXXX-----x-------xx-----[]---x-------------------<>---------xx--------------
E---EE--------xxx---xxXXXXXX------x-----xx------[]----x------------------xxx-------xx<>-------------
xxxxxxxxxxxxxxxE-xxxxXXXXXXX-------xxxxxx--X----[]-----xxxxxxxxxxxxxxxxxxxE-xxxxxxxx-[]--E----------
XXXXXXXXXXXXXX<>-XXXXXXXXXXXXXXXXXXXXXXXXXXXXXXXXXXXXXXXXXXXXXXXXXXXXXXXXXXXXXXEXXXXXXXXXXXXX-------