--------------------------------------------------
--------------------------------------------------
-------------------------------------------[]S----
-------------------------------------------[]-----
------xxxxx--------------------------------[]-----
-----xxXXX-x-----------E--------SSSSSS-----<>-----
----xx-XXX--x---------<>--------------------------
---xx--XXX---x--------[]--------------------------
-x-xXX-XXX----x-------[]------------------xxxx----
xx-XXX-XXX-----x------[]---------E-----xxxx---x---
xX-XXX-XXX------x---------xxxx--------xx-<>----xxx
XXxXXX-XXX-------xxx-----xx<>-x------xx--[]----<>-
XXxXXX-XXX-------XX-xxxxxx-[]--xxxxxxx---[]----[]-
XXXXX--XXXXXXXXXXXXXXXXXXXXXXX-XXXXXXX--XXXXXXXXXX