--------------------------------------------------
xxxxxxxxxxxxxxxxxxxxxxxxxxxxxxxxxxxx--------------
SSSSSSSSSSSSSSSSSSSSSSSSSSSSSSSSSSS-x---SSSSSSSSSS
-------------------------------------x--SSSS------
--------------------------------------x-SSSS------
----------E----------------------------xSSSS------
---------<>-----------------------------x---------
---------[]------------------------------x--------
---------[]------S-----------------------oxxx-----
----E--SS[]S?--E----E----E--------------S?SS-x----
---<>----[]---<>---<>---<>--------E-----SSS---x--x
---[]----[]---[]---[]---[]-------<>-----SS-----xxx
E--[]-E--[]---[]---[]---[]-------[]-------E-EE--xX
XXXXXXXXXXXXXXXXXXXXXXXXXXXXXXXXXXXXXXXXXX-XXXXXXX