--------------------------------------------------
--------------------------------------------------
--------------------------------------------------
--------------------------------------------------
----------------------------------------------xxx-
---------------------------------------------xx--x
----xxxxxxxx--------------------------------xx----
---xxXXXXXX-x------------------------------xx-----
--xxXXX------x----xx------------xxxxxxxxxxxx------
-xxXXXX-------x--xx-x-xxxxxx---xx-XXXXXXXXXS------
xxXXXXX--------xxx---xx-----x-xx------------------
xXXXXXX---------x----<>------xx-------------------
XX-XXXX--<>----<>----[]------<>-------------------
XXXXXX---[]----[]----[]------[]------------XXXXXXX