----------------------------------------------------------------------------------------------------
---------------------xxxxxxxxxxxxxxxxxxxxx-xxx----------------------------------------------------xx
SSSSSSSSSSSS--------xxSSSSSSSSSSSSSSSSSSSSSSSS---------------------------------------------------xxX
SSS----------------xx---------------------[]-----------------------------------------------------x--
SSS-----------XXX-xx----------------------[]----------------------------------------------------xx--
SSS--QQ------xxxx-xSSS--------------------[]---------------------------------------------------xx---
------------xx---xx-----------------------[]----------XX-EX-----------------------------------xxXX--
--xxx-xxx--xx-----xS----------------------<>----------XX--X----------------------------------xx-----
xxx--xx--xxx------S-S--------------E------------X---X-XX--X------------xxxx--S-----------xxxxx------
SSS--QQ--QQQ---------S------------<>------------XSSSX-XSS?X---SSS-----xxXX-x------------xx-XXX------
SSS---------------------SSS-------[]-----S---S-----------------------xx-XX--xxxx-------xx-----------
SSS---------------------SSS-------[]-----S---S----------------------xx--XX--SSS-x-----xx------------
SSS------------------------ooooo--[]-----Sx--Sxxxxxxxxxxxxxxxxxxxxxxx--EX---SSS--xxxxxx-------------
XXXXXXXXXXXX------XXXXXXXXXXXXXX--[]-----S-x-SXXXXXXXXXXXXXXXXXXXXXXXXXXXXXXXXXXXXXXXXX-------------