E---------------------------------------------------------------------------------------------------
----------------------------------------------------------------------------------------------------
----------------------------------------------------------------------------------------------------
---------------------------------------------------------------------------------------------------x
---------------------------E--------------------------------------------E-------------------------xx
-----------------------QQQQQQQQQ----------------E---------------------SSQSS--SQS-----------------xx-
-----------------------------------------------SSSS--------------------------------------------xxx--
-----------------------------------------------------------------------------------------o-----xXX--
---------------xxxx---------E--------------X-E--E-----------------E------E----------------E----xXX--
--------------xx<>-x--E?QQQQQQQQ-----------XS?SSSSS---X----------<>---SSSSS--S?S-------SSSSS--xxXX--
xxxxxx-------xx-[]--x------------------xxx---------EE-X------------------------------E-E-----xxXXX--
x-----x-----xx--[]---x----------------xxX-xSSSSSSSSSSSX------------------------------------Exx-XXX--
X------xxxxxx---[]----xxxxxxxxxxxxxxxxx-X--xxxxxxxxxxxxxxxxxxxxxxxxxxxxxxxxxxxxxxxxxxxxxxxxxx--XXX--
X-----XXXXXXXXXXXXXXXXXXXXXXXXXXXXXXXXXXXXXXXXXXXXXXXXXXXXXXXXXXXXXXXXXXXXXXXXXXXXXXXXXXXXXXXXXXXX--