----------------------------------------------------------------------------------------------------
----------------------------------------------------------------------------------------------------
SS---SSSSSSSSSSSSSSSSSSSSSS?SSSSSSSSSSSSSSSSSSSSSSSSSSSSSSSSSSS-------------------------------------
SS------------SSSS----------------------------------------------------------------------------------
SS------------SSSS----------------------------------------------------------------------------------
SS---Q----QQ----------oooooo----------------------------------------------------------SSSSSSSS------
----------SS----------------------------------------------------------------------------------------
-----S----SS----------SSSSSS-----------------------------------------------E------------------------
-----So??-SS---E------SSSSSS--------------------------------xxxxx------E---------------E---E--------
-----SSS--SS--SSSS----------------------------xxxx---------xxXXX-xxxxxxxxxxxxxxxxx---SSSSSSSSS------
xxx----------EE------------------------X-----xxSS-x-------xxEXXX-XXXXXXXXXXXXXX<>-x-----------------
<>-x-------------xxxxx----------------XX----xx-SS--x-----xxXXXXX-------------XX[]--x------xxx-----xx
[]--xxxxxxxxxxxxxx----xxxxxxxxxxxxxxxxxxxxxxx--SS---xxxxxxXXXXXX-------------X-[]---xxxxxxx--xxxxxxX
XXXXXXXXXXXXXXXXXX---XXXXXXXXXXXXXXXXXXXXXXXX--XX--XXXXXXXXXXXX--------------X-XXXXXXXXXXXX--XXXXXXX