----------------------------------------------------------------------------------------------------
----------------------------------------------------------------------------------------------------
----------------------------------------------------------------------------------------------------
----------------------------------------------------------------------------------------------------
----------------------------------------------------------------------------------------------------
----------------------------------------------------------xxxx------xx-------------------------xxxxS
---------------------------------------------------------xx---x----xx-x-E---------------------xx--xx
--------------------------------------------------------xx-----x--xx---x-----------------xx--xx-----
?-----------------E------------------------------------xx-------xxx-----x------E--------xx-xxx----E-
---S-SSS----E----<>--------------------E--S-----------xxX-------XXX------x----->------xxx--XXX------
----E------<>-------------------------<>--------E----xxXXX----X-----------x------------x---XXX------
E----------------------xxxxx-------------------<>---xxXXXX---XXX-----------x-----------X---XXX------
xxxxxxxxxxxxxxxxxxxxxxxx----xxxxxxxxxxxxxxxxxxxxxxxxxXXXX------------------XxxxxxxxxxxxXX--XXX------
XXXXXXXXXXXXXXXXXXXXXXXX---XXXXXXXXXXXXXXXXXXXXXXXXXXXXXX------------------XXXXXXXXXXXXXXXXXXX------