----------------------------------------------------------------------------------------------------
----------------------------------------------------------------------------------------------------
----------------------------------------------------------------------------------------------------
---------------------xxxxxxxxx-----------------------------------------------------------xxx--------
-----------xxxx----xxx---x----x------------------------------------------------xxxx----xxx--x-------
----------xx---x--xxXS---E-----x-------------------------x--------------------xx---x--xxXS---x------
---------xx-----xxxEX---<>------x-----------xxxx----------x------------------xx-----xxxEX-----x-----
--------xx-------xXXX---[]-------x---------xx---x----------x----------------xx-------xXXX------x----
------xxx--------XXXXS--[]--------x-xxxxx-xx-----x----------x-------------xxx--------XXXXS------x---
-----xx<>-------XXXXX---[]---------xx----xx------<xx---------x------S?S--xx<>-------XXXXX--------x--
----xx-[]------XXXXXX---[]---------<>----<>------[]-x---------x---------xx-[]------XXXXXX---------x-
xx-xx--[]-----XXXXXXX---[]---------[]----[]------[]--x---------x-------xx--[]-----XXXXXXX----------x
E-xx---[]----XXXXXXXX---[]---------[]-E--[]------[]---xxxx----X-xxxxxxxx---[]----XXXXXXXX---------X-
XXXXXXXXXXXXXXXXXXXXXXXXXXXXXXXXXXXXXXXXXXXXXXXXXXXXXXXXXXXXXXXXXXXXXXXXXXXXXXXXXXXXXXXXXXXXXXXXX-XX