--------------------------------------------------
--------------------------------------------------
--------------------------------------------------
--------------------------------------------------
--------------------------------------------------
E---------xxxx--------------------------------SS--
---------xx---x------xxxxx------------------------
---xxxxxxx-----x-xxxxx----x-----------------------
-xxx----x-------xx--<>-----xxx----S---------------
xx<>---<>-------<>--[]-----<>-x-------------------
x-[]---[]-------[]--[]-----[]--x------------------
--[]---[]-------[]--[]-----[]---x-----xxx---------
--[]---[]-------[]--[]-----[]----xxxxxx--xxxxxxxxx
XXXX---[]-------XX--XXXXXXXXXXXXXXXXXXX--XXXXXXXXX