----------xxx-----------------xxxx------------------------------------------------------------------
---------xx--x------xxx------xx--x------------------------------------------------------------------
--------xx----x----xx--x----xx----x-----------------------------------------------------------------
-------xx------x--xx----x--xx------x----------------------------------------------------------------
------xxE-------xxx------xxx--------x-------xxx--------oo-------------------------------------E-----
-----xx<>--------x-------XXX---------x-----xx--x-----------------------------------------SSSSSSSSSSS
----xxX[]-------XX--------------------x---xx----x---------------------------------------------------
----xXX[]------------------------------x-xx------x-----------------------------------------E--------
--xxxXX[]-----------------------SS------xx--o-----xxx---------xxxx------E---------------------------
-xx<>XX[]-------------------------------<>--------<>-x-------xx<>-x----<>----------------S?S--------
xx-[]XX[]-------------------------------[]--------[]--x-----xx-[]--x--------------------------------
x-X[]XX[]-------------------------------[]--------[]---x---xxSS[]---x--------xxxxx---------------xxx
-XX[]XX[]---------------o---o-----------[]--------[]-E-Exxxx-SS[]----xxxxxxxxx----xxxxxxxxxxxxxxxx--
XXXXXXXXXXXXX-----------X---X-----------XXXXXXXXXXXXXXXXXXXXXXXXXXXXXXXXXXXXXX---XXXXXXXXXXXXXXXXX--