--------------------------------------------------
--------------------------------------------------
SSSSSSSSSSSSSSSSSSSSSSSSSSSSSSSSSSSSSSSSSSSSSSSSSS
-------------------------------------------SSSSSSS
E-----------------xxx----------------------SSSSSSS
QQ---------xxxxxxxx--x---------------------SSSSSSS
----------xxSSSSSSS---xxxxxx----------------------
---------xx-SSSSSSS--SSSSSS-x---------------------
xxxxxxxxxx--SSSSSSS--SSSSSS--xxxxxxxxxxxxxxxxxxxxx
SSSSSSSSSS--SSSSSSS--SSSSSS?SS?SSSSS???????SSSSSSS
SSSSSSSSSS--------------------SSSSSSSSSSSSS-------
SSSSSSSSSS---------<>---------SSSSSSSSSSSSS-------
SSSSSSSSSS---------[]-----------------------------
XXXXXXXXXXXXXXXXXXXXXXXXXXXXXXXX-XX-XXXXXXXXXXXXXX