----------------------------------------------------------------------------------------------------
------xx--------------------------------------------------------------------------------------------
XSSSSSSSSSSSSSSSSSSSS?SSSSSSSSSSSSSS----------------------------------------------------------------
-------------------------------SSSSS---------------------------------------------------------xx-----
-------------------------------SSSSS--------xxxxxxxxxxx----------E-E---------------xxxx----xxx-x----
-------------------------------SSSSS-------xx--QQQ?QQQ-x-------SSSSSSS-SS-xxxx-----x---x--xxXS--x---
---------------------xxxxxx----SSSSS------xx------------x-------------E--xx---x---xx----xxxEX----x--
----------------xxxxxx-----x---SSSSS-----xx------E-------x--------------xx-----x-xx------xXXX-----x-
---------------xxXXXXX------xx-SSSSS---xxx-----SSSSSSS----x-----------xxx-------xx-------XXXXS-----x
--------------xxXXXXXX-----<>-x---SS--xx<>--------------E--x---------xx<>-------<>------XXXXX-------
-----<>-----xxxXXXXXXX-----[]--x--SS-xx-[]-------X------X---x---E---xx-[]-------[]-----XXXXXX-------
x----[]-xx-xxXXXXXXXXX-----[]---x-SSxx--[]-------X------X----x-----xx--[]-------[]----XXXXXXX-------
-xxxx[]-E-xx-XXXXXXXXX-----[]----xxxx---[]----E--X------X-----xxxxxx---[]-------[]---XXXXXXXX-------
XXXXXXXXXXXXXXXXXXXXXX---XXXXXXXXXXXXXXXXXXXXXXXXXXXXXXXXXXXXXXXXXXXXXXXX-------XX-XXXXXXXXXXXXXXXXX