----------------------------------------------------------------------------------------------------
----------------------------------------------------------------------------------------------------
----------------------------------------------------------------------------------------------------
----------------------------------------------------------------------------------------------------
----------------------------------------------------------------------------------------------------
------------------------------------------------------SSS----Q--------------------------------------
--------------------------------------------------------------------------------xxxx----------------
-------------------------------------------------------------------------------xx---x---------------
B-----------------------------<>----------------------------------------------xx-----xxx-------xxxx-
b-----------------------------[]-----?QQQQQQQ?-----S--------?SQS------------xxx------<>-x-----xx<>-x
E---?QQ-----------------------[]----------------------------------xxxx-----xx<>------[]--x---xx-[]--
-----------]--------xxx-------[]-----B---------------------------xx<>-x---xx-[]------[]---x-xx--[]--
xxxxxxxxxxxxxxxxxxxxx--xxxxxxx[]-----b-E-----B-----xxxxxxxxxxxxxxx-[]--xxxx--[]-E----[]----xx-E-[]--
XXXXXXXXXXXXXXXXXXXXX--XXXXXXXXXXXXXXXXXXXX-XXXXXXXXXXXXXXXXXXXXXXXXXXXXXXXXXXXXXXXXXXXXXXXXXXXXXXXX