--------------------------------------------------
--------------------------------------------------
--------------------------------------------------
--------------------------------------------------
----------xxx--------oo---------------------------
S--------xx--x------------------------------------
--------xx----x-----------------------------------
-------xx------x----------------------------------
------xx--o-----xxx-------------------------------
QQQxxx<>--------<>-x------------------------------
--xx--[]--------[]--x-----xxxx--------------------
-xx---[]--------[]---x---xx<>-x------------------x
xxX---[]--------[]-E-Exxxx-[]-Exxxxxxxxxxxxxxxxxxx
XXX---XXXXXXXXXXXXXXXXXXXXXXXXXXXXXXXXXXXXXXXXXXXX