------------------------------------------------------------------------------------------------xxx-
-------------------------xxxx----------xxxxxxxxxxxxxxxxxxx-------------------------------------xx--x
SSSSSSSSSSSSSSSSSSSSSSSSSSSSSS--------xxSSSSSSSSSSSSSSSSSS------------------SSSSSSSSS-------SSSSX---
SSSSSSSSSSSSSSSSSSSSS----------------xx---------------------------------------------------------X---
SSSSSSSSSSSSSSSSSSSSS-----------XXX-xx--------------------------------------------------ExxxxxxXX---
SSSSSSSSSSSSSSSSSSSSS--QQ------xxxx-xSSS------------E---------------------------------xxxx-QQQXXX---
------------------------------xx---xx--------------<>--------------------------------xx-x-----XXX---
-xxx----------------xxx-xxx--xx-----xS-------------[]-------------------------------xx--X----EXXX---
xx?-xxxxxxxxxxxxxxxxx--xx--xxx------S-S------------[]------------xxxx-?-----ooo-xxxxx------SSSSSo---
SX??SSSSSSSSSSSSSSSSS--QQ--QQQ---------S------E--SS[]-----------xx<>-x---------xxXXXX---------XXX---
S---SSSSSSSSSSSSSSSSS------------------------<>----[]---SS-----xx-[]--x-------xx-------------XXXX---
----SSSSSSSSSSSSSSSSS------------------------[]----[]---SS----xx--[]---x-----xx--------------XXXX---
ooooSSSSSSSSSSSSSSSSS------------------------[]-E--[]---SSxxxxx---[]----xxxxxx------------E--XXXX---
XXXXXXXXXXXXXXXXXXXXXXXXXXXXXX------XXXXXXXXXXXXXXXXXX--XXXXXXXXXXXXXXXXXXXXXX----------XXXXXXXXX--X