----------------------------------------------------------------------------------------------------
----------------------------------------------------------------------------------------------------
]---------------XXXX--------------------------------------------------------------------------------
]----------------[]---------------------------------------------------------------------------------
]----------------[]----------------------------------xxxxxxxxxxx------------------------------------
]----------------[]---------------------------------xx---x---XX-x-------------SSSSSS----------------
]----------------[]--------------------------------xx-E--E---[]--x------------------------xxx-------
>----------------[]------------------------------xxx---------[]---x----------------------xx--x------
-----------------[]------xxxx-------------------xx-E---------[]----x--------------------xx----x-----
QQQQQ?QQQQQQQ?Q--<>-----xxX--x-----------------xx------------[]-----xx------------xxxx-xx------x----
S----------------------xx-X---x---------------xx-------------<>-----B-x----------xx---xx---SSS--x---
Sxxx------------------xx--X----x-------------xx---------------------b--x-----SSSxx----<>---SSS---x--
Sx--xxxxxxxxxxxxxxxxxxx--EX-----xxxxxxxxxxxxxxX---------------E-----B---xxxxxxxxx-----[]---SSS----xx
XEEXXEXXXXXXEXEXXXXXXXXXXXX-----XXEXXXXXXXXXXXX-------------XXXXXXXXXXXXXXXXXXXXX-----XXXX-XXXXXXXXX