----------------------------------------------------------------------------------------------------
----------------------------------------------------------------------------------------------------
----------------------------------------------------------------------------------------------------
----------------------------------------------------------------------------------------------------
-----------------------------xxxx----------------------------------------------xxxx-----------------
>------------Q-?-Q----------xx---xSSS-----------------------------------------xx---xSSS-------------
]--------------------------xx-----x--xxxxxxxxxx------------------------------xx-----x--xxxxxxxxx----
]------------------E---E--xx-------xxxXXXXXXXX-x----------------------------xx-------xxxXXXXXXX-x---
x-----------xxx----xxxxxxxx---------xXXXXXXXX---x----xx-----------xxxxxxxxxxx---------xXXXXXXX---x--
-xxxxxxxxxxxxE-xxxxxXXXXXXX---------XXXX---------x--xx-x-xxxxx---xx-XEXXXXXXX---------XXXX--------x-
XXXXXXXXXXXXXEXXXXXXX--------------XXXXX----------xxx---xx----x-xx-------------------XXXXX---------x
XXX-------------------------------XXXXXX-----------x----<>-----xx-------------------XXXXXX----------
XX-------------------------------XXXXXX----<>-----<>----[]-----<>------------------XXXXXX---<>-----<
XX-------------------------------XXXXXX----[]-----[]----[]-----[]------------------XXXXXX---[]-----[