----------------------------------------------------------------------------------------------------
----------------------------------------------------------------------------------------------------
---------------------------------------------------------------------------------?------------------
----------------------------------------------------------------------------------------------------
----------------------------------------------------------------------------------------------------
----------------------------------------------------------------SSSSS-------------------xxxxx-------
------------E----------------------------------------------------------------------SS--xx----x------
-----------<>-------------------------------------------------------------------------xxX-----x-----
-xxxxxx----[]----------------------------xxxxx-------------------E-------------SS----xxXX------x----
xxXSSS-x---XX--------------------------xxx----x-----------------SSSSS-xxx-----------xxXXX-------x---
x-X-----x--------xxxx-----------------xx<>-----xx---------xxxx-------xxX-x--B------xxXXXX--------x--
x-X------x----B-xx<>-x---B---------B-xx-[]----<>-x---B---xx<>-x-----xx-X--x-b----xxxXXXXX---------x-
-EX-------xxxxxxx-[]--xxxxxxxxxxxxxxxx--[]-E--[]--xxxxxxxx-[]--xxxxxx--X---xxxxxxx-XXXXXX---E----X-x
XXX-XXX---XXXXXXXXXXXXXXXXXXXXXXXXXXXXXXXXXXXXXXXXXXXXXXXXXXXXXXXXXXXXXXXXXXXXXXXX-XXXXXXXXXXXXXXXXX