----------------------------------------------------------------------------------------------------
----------------------------------------------------------------------------------------------------
------------------------------------------------------------------------------------SSSSSSSSSSSSSSSS
--------------------------------------------------------------------------------------------SSSSSSSS
--------------------------------------------------------------------------------------------SSSSSSSS
E----------------------E------SSSSSSSSSS----------------E----------------S----S---------xx--SSSSSSSS
]---------------------<>----------------------------QQQQQQQ----------------------------xx-----------
]---------------------[]----------------------B---------------------------------------xx--------xxx-
x---------------------[]-------------xxxx-----b-------------------------xxxx---------xx---xxxxxxx?-x
-x------------xxxx---SXXS-S---------xx--xxx---XSS--------xxxxx---------xx<>-x-------xx----S?SSSSS??S
--x----------xx<>-x------xxxx------xx------x------------xx----xx------xx-[]--x-----xxE----SSSSSS---S
---x------B-xx-[]--x----xx<>-x----xx--------x----------xx----<>-x----xx--[]---x---xx<>----SSSSSS---S
E---xxxxxxxxx--[]---xxxxx-[]--xxxxx----------xxxxxxxxxxx-----[]--xxxxx---[]----xxxx-[]----------oooS
XXXXXXXXXXXXXXXXXXXXXXXXXXXXXXXXXXX------S---XXXXXXXXXXXE-X-XXXXXXXXXXXXXXXXXXXXXXXXXXXXXXXXX-XXXXXX